com.vmware.admiral.adapter.registry.service.RegistryAdapterServiceTest.testSameRegistryTwoDifferentProjectsNotRemoveOldTenantLinkShouldFail,flaky,31,30,0,1
io.undertow.websockets.jsr.test.JsrWebSocketServer07Test.testErrorHandling,flaky,160,153,0,7
io.vertx.rabbitmq.RabbitMQServiceTest.testMessageOrderingWhenConsumingNewApi,flaky,104,98,0,6
delight.nashornsandbox.TestMemoryLimit.test_no_abuse,flaky,102,98,0,4
io.logz.sawmill.PipelineExecutorTest.testOnSuccessPipelineExecution,flaky,102,101,0,1
io.logz.sawmill.processors.ConvertFieldProcessorTest.testConvertToBoolean,flaky,102,101,0,1
org.apache.hadoop.fs.http.server.TestHttpFSServer.testCreateSnapshot,flaky,36,35,0,1
cn.hutool.cron.test.CronTest.matchAllTest,flaky,2144,2141,0,3
org.apache.dubbo.rpc.protocol.dubbo.DubboLazyConnectTest.testSticky1,flaky,180,179,0,1
org.java_websocket.misc.OpeningHandshakeRejectionTest.testHandshakeRejectionTestCase3,flaky,3974,3973,0,1
org.apache.dubbo.rpc.protocol.http.HttpProtocolTest.testGenericInvokeWithNativeJava,flaky,217,216,0,1
org.java_websocket.misc.OpeningHandshakeRejectionTest.testHandshakeRejectionTestCase1,flaky,3974,3970,0,4
retrofit2.adapter.rxjava.CompletableThrowingTest.throwingInOnCompleteDeliveredToPlugin,flaky,751,748,0,3
org.java_websocket.misc.OpeningHandshakeRejectionTest.testHandshakeRejectionTestCase7,flaky,3974,3971,0,3
org.java_websocket.misc.OpeningHandshakeRejectionTest.testHandshakeRejectionTestCase6,flaky,3974,3973,0,1
org.apache.hadoop.registry.client.impl.TestCuratorService.testRM,flaky,31,30,0,1
org.java_websocket.misc.OpeningHandshakeRejectionTest.testHandshakeRejectionTestCase4,flaky,3974,3971,0,3
org.apache.hadoop.registry.secure.TestSecureLogins.testDefaultRealmValid,flaky,31,30,0,1
com.cloudera.oryx.common.io.IOUtilsTest.testDistinctFreePorts,flaky,324,321,0,3
com.vmware.admiral.adapter.registry.service.RegistryAdapterServiceTest.testSameRegistryAsGlobalAndProject,flaky,31,30,0,1
org.apache.hadoop.registry.secure.TestSecureLogins.testUGILogin,flaky,31,30,0,1
io.vertx.mqtt.test.server.MqttServerClientPublishTest.publishQos0,flaky,102,101,0,1
org.java_websocket.protocols.ProtoclHandshakeRejectionTest.testHandshakeRejectionTestCase8,flaky,3974,3972,0,2
org.java_websocket.protocols.ProtoclHandshakeRejectionTest.testHandshakeRejectionTestCase9,flaky,3974,3973,0,1
org.java_websocket.protocols.ProtoclHandshakeRejectionTest.testHandshakeRejectionTestCase4,flaky,3974,3971,0,3
com.github.kagkarlsson.scheduler.WaiterTest.should_wait_until_woken,flaky,102,100,0,2
org.java_websocket.protocols.ProtoclHandshakeRejectionTest.testHandshakeRejectionTestCase6,flaky,3974,3972,0,2
com.outbrain.aletheia.SampleDomainClassDatumTest.testDatumRoutes,flaky,102,97,0,5
org.vertexium.accumulo.AccumuloGraphTest.testFindRelatedEdgesPerformance,flaky,2,1,0,1
org.java_websocket.protocols.ProtoclHandshakeRejectionTest.testHandshakeRejectionTestCase2,flaky,3974,3972,0,2
org.java_websocket.protocols.ProtoclHandshakeRejectionTest.testHandshakeRejectionTestCase3,flaky,3974,3972,0,2
io.undertow.websockets.jsr.test.JsrWebSocketServer08Test.testErrorHandling,flaky,160,146,0,14
org.zalando.riptide.backup.BackupRequestPluginTest.shouldUseBackupRequest,flaky,103,102,0,1
net.redpipe.templating.freemarker.ApiTest.checkTemplateNegociationText,flaky,22,15,0,7
com.oracle.bmc.objectstorage.transfer.ProgressTrackerTest.multipartUploadProgressTrackerFactory_simulateRealLifeScenario,flaky,203,195,0,8
io.elasticjob.lite.lifecycle.api.JobAPIFactoryTest.assertCreateServerStatisticsAPI,flaky,1986,1980,0,6
org.springframework.cloud.aws.cache.config.xml.CacheBeanDefinitionParserTest.parseInternal_cacheConfigWithExpiration_returnsConfiguredCacheThatRespectExpiration,flaky,102,101,0,1
org.java_websocket.issues.Issue580Test.runNoCloseBlockingTestScenario0,flaky,3974,3973,0,1
uk.co.flax.luwak.matchers.TestPartitionMatcher.testParallelSlowLog,flaky,102,101,0,1
ro.pippo.session.mongodb.MongoDBSessionDataStorageTest.testCreate,flaky,118,115,0,3
delight.nashornsandbox.TestGetFunction.test,flaky,102,101,0,1
org.java_websocket.misc.OpeningHandshakeRejectionTest.testHandshakeRejectionTestCase9,flaky,3974,3973,0,1
com.spotify.helios.testing.HeliosSoloDeploymentTest.testUndeployLeftoverJobs,flaky,169,155,0,14
com.openpojo.reflection.impl.PojoClassImplTest.shouldCreateInstanceOnAbstract,flaky,133,127,0,6
org.java_websocket.misc.OpeningHandshakeRejectionTest.testHandshakeRejectionTestCase8,flaky,3974,3972,0,2
net.redpipe.engine.swagger.SwaggerApiTest.checkSwagger,flaky,103,101,0,2
org.apache.dubbo.rpc.protocol.dubbo.DubboProtocolTest.testPerm,flaky,180,179,0,1
io.vertx.mqtt.test.server.MqttServerConnectionTest.connectionAlreadyAccepted,flaky,102,100,0,2
org.apache.hadoop.fs.http.server.TestHttpFSServer.testAllowSnapshot,flaky,36,35,0,1
com.querydsl.hibernate.search.SearchQueryTest.listResults,flaky,14,7,0,7
io.elasticjob.lite.spring.job.JobSpringNamespaceWithoutListenerTest.assertSpringJobBean,flaky,1981,1977,0,4
io.vertx.rabbitmq.RabbitMQConsumptionStreamingTest.pauseAndResumeShouldWork,flaky,104,81,0,23
io.vertx.mqtt.test.server.MqttServerUnsubscribeTest.unsubscribe,flaky,102,101,0,1
org.java_websocket.issues.Issue256Test.runReconnectBlockingScenario7,flaky,3974,3902,0,72
org.apache.hadoop.fs.http.server.TestHttpFSServer.testDelegationTokenOperationsSsl,flaky,36,35,0,1
org.java_websocket.misc.OpeningHandshakeRejectionTest.testHandshakeRejectionTestCase2,flaky,3974,3973,0,1
org.java_websocket.protocols.ProtoclHandshakeRejectionTest.testHandshakeRejectionTestCase16,flaky,3974,3972,0,2
org.java_websocket.protocols.ProtoclHandshakeRejectionTest.testHandshakeRejectionTestCase17,flaky,3974,3972,0,2
org.java_websocket.protocols.ProtoclHandshakeRejectionTest.testHandshakeRejectionTestCase14,flaky,3974,3972,0,2
org.apache.dubbo.rpc.protocol.dubbo.DubboProtocolTest.testReturnNonSerialized,flaky,180,179,0,1
org.java_websocket.protocols.ProtoclHandshakeRejectionTest.testHandshakeRejectionTestCase10,flaky,3974,3953,0,21
org.java_websocket.protocols.ProtoclHandshakeRejectionTest.testHandshakeRejectionTestCase11,flaky,3974,3971,0,3
com.codingchili.TestWriter.shouldWriteToElasticPort,flaky,113,82,0,31
org.jasig.cas.client.validation.AssertionImplTests.testAssertionValidity,flaky,102,101,0,1
io.vertx.rabbitmq.RabbitMQServiceTest.testBasicConsume,flaky,104,102,0,2
org.apache.hadoop.lib.service.hadoop.TestFileSystemAccessService.fileSystemCache,flaky,36,35,0,1
org.apache.dubbo.remoting.exchange.support.header.HeartbeatHandlerTest.testHeartbeat,flaky,161,160,0,1
com.vmware.admiral.adapter.registry.service.RegistryAdapterServiceTest.testV1Ping,flaky,31,30,0,1
org.apache.hadoop.yarn.server.timeline.TestEntityGroupFSTimelineStore.testMoveToDone,flaky,31,30,0,1
org.java_websocket.misc.OpeningHandshakeRejectionTest.testHandshakeRejectionTestCase5,flaky,3974,3972,0,2
org.apache.hadoop.fs.http.server.TestHttpFSServer.testGetSnapshotDiffIllegalParam,flaky,36,35,0,1
io.vertx.rabbitmq.RabbitMQClientReconnectTest.testReconnect,flaky,104,101,0,3
org.java_websocket.misc.OpeningHandshakeRejectionTest.testHandshakeRejectionTestCase10,flaky,3974,3932,0,42
io.vertx.mqtt.test.server.MqttServerConnectionTest.accepted,flaky,102,101,0,1
org.java_websocket.misc.OpeningHandshakeRejectionTest.testHandshakeRejectionTestCase11,flaky,3974,3971,0,3
org.java_websocket.issues.Issue713Test.testIssue,flaky,3974,3972,0,2
com.lcw.one.main.EmailServiceTest.sendEmailList,flaky,202,188,0,14
timely.store.iterators.TimeSeriesGroupingIteratorTest.testMultipleTimeSeriesMovingAverage,flaky,144,140,0,4
org.java_websocket.misc.OpeningHandshakeRejectionTest.testHandshakeRejectionTestCase0,flaky,3974,3973,0,1
io.elasticjob.lite.spring.job.JobSpringNamespaceWithListenerAndJdkDynamicProxyTest.assertSpringJobBean,flaky,1980,1979,0,1
io.elasticjob.lite.spring.job.JobSpringNamespaceWithEventTraceRdbTest.assertSpringJobBean,flaky,1980,1978,0,2
org.apache.hadoop.fs.http.server.TestHttpFSServer.testDisallowSnapshot,flaky,36,35,0,1
org.apache.dubbo.rpc.protocol.http.HttpProtocolTest.testTimeOut,flaky,217,216,0,1
ro.isdc.wro.extensions.processor.TestRubySassCssProcessor.shouldBeThreadSafeWhenInitializingProcessor,flaky,268,266,0,2
org.java_websocket.issues.Issue256Test.runReconnectScenario7,flaky,3974,3892,0,82
info.archinnov.achilles.embedded.PortFinderTest.try_to_find_first_port,flaky,815,814,0,1
io.yawp.testing.appengine.pipes.flow.FlowDropsTest.testFlowDropsToSameSink,flaky,304,300,0,4
com.baidu.disconf.client.test.DisconfMgrTestCase.demo,flaky,3064,3063,0,1
com.outbrain.aletheia.SampleDomainClassDatumTest.test_multiple_routes,flaky,102,95,0,7
org.vertexium.inmemory.InMemoryGraphTest.testMarkPropertyVisible,flaky,102,101,0,1
com.querydsl.hibernate.search.SearchQueryTest.paging,flaky,14,7,0,7
org.apache.dubbo.rpc.protocol.dubbo.telnet.ListTelnetHandlerTest.testListService,flaky,180,178,0,2
org.java_websocket.issues.Issue256Test.runReconnectScenario2,flaky,3974,3858,0,116
cn.edu.hfut.dmic.webcollector.util.OkHttpRequesterTest.testHttpCode,flaky,37460,37457,0,3
com.vmware.admiral.adapter.registry.service.RegistryAdapterServiceProxyTest.testInitWithProxyWithList,flaky,31,29,0,2
org.java_websocket.issues.Issue256Test.runReconnectBlockingScenario9,flaky,3974,3904,0,70
org.java_websocket.issues.Issue256Test.runReconnectBlockingScenario8,flaky,3974,3907,0,67
io.elasticjob.lite.lifecycle.api.JobAPIFactoryTest.assertCreateJobStatisticsAPI,flaky,1985,1982,0,3
com.github.kagkarlsson.scheduler.SchedulerTest.scheduler_should_execute_rescheduled_task_when_exactly_due,flaky,102,101,0,1
com.outbrain.aletheia.SampleDomainClassDatumTest.test_avro_route,flaky,102,96,0,6
org.java_websocket.issues.Issue256Test.runReconnectBlockingScenario1,flaky,3974,3912,0,62
org.java_websocket.issues.Issue256Test.runReconnectBlockingScenario0,flaky,3974,3908,0,66
org.java_websocket.issues.Issue256Test.runReconnectBlockingScenario3,flaky,3974,3904,0,70
org.java_websocket.issues.Issue256Test.runReconnectBlockingScenario2,flaky,3974,3915,0,59
org.java_websocket.issues.Issue256Test.runReconnectBlockingScenario5,flaky,3974,3913,0,61
org.java_websocket.issues.Issue256Test.runReconnectBlockingScenario4,flaky,3974,3914,0,60
cern.c2mon.daq.filter.dynamic.DiffTimeDeadbandActivatorTest.testNoActivationOnFirstRecord,flaky,102,100,0,2
org.java_websocket.issues.Issue256Test.runReconnectBlockingScenario6,flaky,3974,3920,0,54
retrofit2.adapter.rxjava.CompletableThrowingTest.bodyThrowingInOnErrorDeliveredToPlugin,flaky,751,750,0,1
com.espertech.esper.example.rfidassetzone.TestLRMovingSimMain.testSim,flaky,98,95,0,3
org.apache.dubbo.rpc.protocol.dubbo.DubboProtocolTest.testDemoProtocol,flaky,180,179,0,1
org.zalando.riptide.failsafe.RetryAfterDelayFunctionTest.shouldRetryOnDemandWithDynamicDelay,flaky,103,102,0,1
com.vmware.admiral.adapter.registry.service.RegistryAdapterServiceTest.testDockerHubListImageTags,flaky,31,30,0,1
ro.pippo.session.mongodb.MongoDBSessionDataStorageTest.testSave,flaky,118,116,0,2
io.undertow.websockets.jsr.test.JsrWebSocketServer13Test.testErrorHandling,flaky,160,155,0,5
org.apache.dubbo.rpc.protocol.dubbo.telnet.ListTelnetHandlerTest.testList,flaky,180,179,0,1
org.apache.dubbo.rpc.protocol.dubbo.DubboProtocolTest.testNonSerializedParameter,flaky,180,179,0,1
org.apache.hadoop.yarn.server.timeline.TestEntityGroupFSTimelineStore.testGetEntityPluginRead,flaky,33,31,0,2
io.vertx.rabbitmq.RabbitMQServiceTest.testBasicCancel,flaky,104,103,0,1
io.vertx.mqtt.test.server.MqttServerClientIdentifierTest.testValidClientIdentifier,flaky,102,101,0,1
io.vertx.rabbitmq.RabbitMQConsumptionStreamingTest.keepMostRecentOptionShouldWorks,flaky,104,103,0,1
ro.pippo.session.mongodb.MongoDBSessionDataStorageTest.testDelete,flaky,118,117,0,1
org.fluentd.logger.TestFluentLogger.testReconnection,flaky,102,101,0,1
retrofit2.CallTest.cancelRequest,flaky,751,749,0,2
org.java_websocket.issues.Issue677Test.testIssue,flaky,3974,3728,0,246
ro.pippo.session.mongodb.MongoDBSessionDataStorageTest.testGet,flaky,118,117,0,1
example.sos.modulith.orders.EmailNotificationTest.completingAnOrderUpdatesInventory,flaky,125,114,0,11
org.java_websocket.issues.Issue580Test.runNoCloseBlockingTestScenario5,flaky,3974,3973,0,1
org.java_websocket.issues.Issue580Test.runNoCloseBlockingTestScenario4,flaky,3974,3972,0,2
net.redpipe.templating.freemarker.ApiTest.checkMail,flaky,22,21,0,1
org.java_websocket.issues.Issue580Test.runNoCloseBlockingTestScenario3,flaky,3974,3973,0,1
org.java_websocket.issues.Issue580Test.runNoCloseBlockingTestScenario2,flaky,3974,3973,0,1
retrofit2.adapter.rxjava.CompletableThrowingSafeSubscriberTest.throwingInOnCompleteDeliveredToPlugin,flaky,751,750,0,1
org.apache.hadoop.yarn.server.timeline.TestLogInfo.testParseBrokenEntity,flaky,31,29,0,2
org.vertexium.inmemory.InMemoryGraphTest.manyVisibilities,flaky,102,100,0,2
org.java_websocket.issues.Issue580Test.runNoCloseBlockingTestScenario8,flaky,3974,3973,0,1
org.glassfish.tyrus.test.e2e.non_deployable.ServerExecutorsManagementTest.testExecutorServicesGetClosed,flaky,4,1,0,3
com.spinn3r.noxy.discovery.zookeeper.ZKTest.testDiscoveryListener,flaky,107,54,0,53
ro.isdc.wro.extensions.processor.TestBourbonCssProcessor.shouldBeThreadSafe,flaky,268,266,0,2
cloud.orbit.actors.extensions.test.LengthFieldHandlerTest.randomMessages,flaky,283,282,0,1
io.vertx.mqtt.test.server.MqttServerConnectionTest.noConnectSent,flaky,102,99,0,3
org.wso2.carbon.apimgt.throttling.siddhi.extension.ThrottleTimeBatchWindowTestCase.throttleTimeWindowBatchTest1,flaky,200,199,0,1
retrofit2.adapter.rxjava.CancelDisposeTest.cancelDoesNotDispose,flaky,751,750,0,1
org.apache.hadoop.yarn.server.timelineservice.reader.TestTimelineReaderWebServices.testGetEntityDefaultView,flaky,22,16,0,6
retrofit2.adapter.rxjava.SingleThrowingTest.responseThrowingInOnSuccessDeliveredToPlugin,flaky,751,748,0,3
com.github.davidmoten.rx2.internal.flowable.FlowableServerSocketTest.testLoad,flaky,102,101,0,1
org.apache.hadoop.yarn.server.timeline.TestEntityGroupFSTimelineStore.testParseSummaryLogs,flaky,31,30,0,1
com.querydsl.hibernate.search.SearchQueryTest.count,flaky,14,1,0,13
com.alibaba.json.bvt.parser.deser.AbstractSerializeTest.test_mapping_1,flaky,392,391,0,1
retrofit2.CallTest.cancelOkHttpRequest,flaky,751,745,0,6
com.alibaba.json.bvt.parser.deser.AbstractSerializeTest.test_mapping_2,flaky,392,391,0,1
org.vertexium.accumulo.AccumuloGraphTest.testFindPathsMultiplePaths,flaky,2,1,0,1
org.apache.hadoop.yarn.server.timeline.TestLogInfo.testParseEntity,flaky,31,30,0,1
net.redpipe.templating.freemarker.ApiTest.checkTemplateNegociationSingleHtml,flaky,22,21,0,1
org.recast4j.detour.tilecache.TileCacheTest.testPerformance,flaky,50,49,0,1
com.github.kagkarlsson.scheduler.compatibility.HsqlCompatibilityTest.test_compatibility,flaky,102,100,0,2
com.spinn3r.noxy.discovery.zookeeper.ZKTest.testBulkClusterJoining,flaky,107,101,0,6
org.apache.hadoop.fs.http.server.TestHttpFSServer.testDirAcls,flaky,36,35,0,1
ro.pippo.session.jedis.JedisSessionDataStorageTest.testDelete,flaky,121,102,0,19
cern.c2mon.server.common.republisher.RepublisherImplTest.testMultipleExceptions,flaky,103,102,0,1
org.apache.dubbo.rpc.protocol.dubbo.telnet.ChangeTelnetHandlerTest.testChangePath,flaky,180,179,0,1
org.apache.hadoop.hbase.procedure2.TestProcedureSkipPersistence.test,flaky,36,33,0,3
me.escoffier.vertx.completablefuture.VertxCompletableFutureTest.testAcceptEitherAsyncWithExecutor,flaky,102,101,0,1
org.java_websocket.protocols.ProtoclHandshakeRejectionTest.testHandshakeRejectionTestCase13,flaky,3974,3971,0,3
org.apache.hadoop.lib.service.hadoop.TestFileSystemAccessService.fileSystemExecutor,flaky,36,35,0,1
io.dropwizard.logging.DefaultLoggingFactoryTest.testConfigure,flaky,587,584,0,3
org.java_websocket.issues.Issue256Test.runReconnectScenario6,flaky,3974,3883,0,91
net.redpipe.discovery.DiscoveryTest.checkWebClient,flaky,71,69,0,2
org.java_websocket.issues.Issue256Test.runReconnectScenario4,flaky,3974,3874,0,100
org.java_websocket.issues.Issue256Test.runReconnectScenario5,flaky,3974,3872,0,102
io.elasticjob.lite.event.rdb.JobEventRdbSearchTest.assertFindJobExecutionEventsWithTime,flaky,2060,2016,0,44
org.java_websocket.issues.Issue256Test.runReconnectScenario3,flaky,3974,3852,0,122
org.java_websocket.issues.Issue256Test.runReconnectScenario0,flaky,3974,3826,0,148
org.java_websocket.issues.Issue256Test.runReconnectScenario1,flaky,3974,3859,0,115
org.apache.hadoop.fs.http.server.TestHttpFSServer.testDisallowSnapshotException,flaky,36,35,0,1
org.java_websocket.issues.Issue256Test.runReconnectScenario8,flaky,3974,3909,0,65
org.java_websocket.issues.Issue256Test.runReconnectScenario9,flaky,3974,3892,0,82
com.outbrain.aletheia.SampleDomainClassDatumTest.test_json_route,flaky,102,93,0,9
io.vertx.rabbitmq.RabbitMQServiceTest.testGetMessageCount,flaky,104,103,0,1
retrofit2.adapter.rxjava.SingleThrowingTest.bodyThrowingInOnSuccessDeliveredToPlugin,flaky,751,750,0,1
io.logz.sawmill.PipelineExecutorTest.testWarnLongProcessingExecution,flaky,102,101,0,1
uk.co.flax.luwak.matchers.TestParallelMatcher.testParallelSlowLog,flaky,102,100,0,2
io.undertow.websockets.jsr.test.reconnect.ClientEndpointReconnectTestCase.testAnnotatedClientEndpoint,flaky,160,158,0,2
com.marcosbarbero.tests.it.Bucket4jInfinispanApplicationTestIT.testExceedingQuotaCapacityRequest,flaky,102,101,0,1
org.vertexium.util.IncreasingTimeTest.currentTimeMillisReturnsTimeGreaterThanSystemTime,flaky,106,86,0,20
retrofit2.adapter.rxjava.ObservableThrowingTest.responseThrowingInOnCompleteDeliveredToPlugin,flaky,751,750,0,1
org.apache.hadoop.lib.servlet.TestServerWebApp.getHomeDirNotDef,flaky,36,35,0,1
org.apache.dubbo.rpc.protocol.dubbo.MultiThreadTest.testDubboMultiThreadInvoke,flaky,180,179,0,1
