cern.c2mon.daq.filter.dynamic.DiffTimeDeadbandActivatorTest.testNoActivationOnFirstRecord,original,pass,2,2,0,0
cern.c2mon.daq.filter.dynamic.DiffTimeDeadbandActivatorTest.testNoActivationOnFirstRecord,random,flaky,100,98,0,2
cern.c2mon.server.common.republisher.RepublisherImplTest.testMultipleExceptions,original,pass,3,3,0,0
cern.c2mon.server.common.republisher.RepublisherImplTest.testMultipleExceptions,random,flaky,100,99,0,1
cloud.orbit.actors.extensions.test.LengthFieldHandlerTest.randomMessages,original,pass,35,35,0,0
cloud.orbit.actors.extensions.test.LengthFieldHandlerTest.randomMessages,random-class,flaky,123,122,0,1
cloud.orbit.actors.extensions.test.LengthFieldHandlerTest.randomMessages,random,pass,123,123,0,0
cloud.orbit.actors.extensions.test.LengthFieldHandlerTest.randomMessages,reverse-class,pass,1,1,0,0
cloud.orbit.actors.extensions.test.LengthFieldHandlerTest.randomMessages,reverse,pass,1,1,0,0
cn.edu.hfut.dmic.webcollector.util.OkHttpRequesterTest.testHttpCode,original,flaky,4140,4139,0,1
cn.edu.hfut.dmic.webcollector.util.OkHttpRequesterTest.testHttpCode,random-class,flaky,16811,16810,0,1
cn.edu.hfut.dmic.webcollector.util.OkHttpRequesterTest.testHttpCode,random,flaky,16503,16502,0,1
cn.edu.hfut.dmic.webcollector.util.OkHttpRequesterTest.testHttpCode,reverse-class,pass,3,3,0,0
cn.edu.hfut.dmic.webcollector.util.OkHttpRequesterTest.testHttpCode,reverse,pass,3,3,0,0
cn.hutool.cron.test.CronTest.matchAllTest,original,pass,842,842,0,0
cn.hutool.cron.test.CronTest.matchAllTest,random-class,pass,650,650,0,0
cn.hutool.cron.test.CronTest.matchAllTest,random,flaky,650,647,0,3
cn.hutool.cron.test.CronTest.matchAllTest,reverse-class,pass,1,1,0,0
cn.hutool.cron.test.CronTest.matchAllTest,reverse,pass,1,1,0,0
com.alibaba.json.bvt.parser.deser.AbstractSerializeTest.test_mapping_1,original,pass,60,60,0,0
com.alibaba.json.bvt.parser.deser.AbstractSerializeTest.test_mapping_1,random-class,pass,162,162,0,0
com.alibaba.json.bvt.parser.deser.AbstractSerializeTest.test_mapping_1,random,flaky,158,157,0,1
com.alibaba.json.bvt.parser.deser.AbstractSerializeTest.test_mapping_1,reverse-class,pass,6,6,0,0
com.alibaba.json.bvt.parser.deser.AbstractSerializeTest.test_mapping_1,reverse,pass,6,6,0,0
com.alibaba.json.bvt.parser.deser.AbstractSerializeTest.test_mapping_2,original,pass,60,60,0,0
com.alibaba.json.bvt.parser.deser.AbstractSerializeTest.test_mapping_2,random-class,pass,162,162,0,0
com.alibaba.json.bvt.parser.deser.AbstractSerializeTest.test_mapping_2,random,flaky,158,157,0,1
com.alibaba.json.bvt.parser.deser.AbstractSerializeTest.test_mapping_2,reverse-class,pass,6,6,0,0
com.alibaba.json.bvt.parser.deser.AbstractSerializeTest.test_mapping_2,reverse,pass,6,6,0,0
com.baidu.disconf.client.test.DisconfMgrTestCase.demo,original,pass,344,344,0,0
com.baidu.disconf.client.test.DisconfMgrTestCase.demo,random-class,pass,1359,1359,0,0
com.baidu.disconf.client.test.DisconfMgrTestCase.demo,random,flaky,1359,1358,0,1
com.baidu.disconf.client.test.DisconfMgrTestCase.demo,reverse-class,pass,1,1,0,0
com.baidu.disconf.client.test.DisconfMgrTestCase.demo,reverse,pass,1,1,0,0
com.cloudera.oryx.common.io.IOUtilsTest.testDistinctFreePorts,original,flaky,60,58,0,2
com.cloudera.oryx.common.io.IOUtilsTest.testDistinctFreePorts,random-class,pass,131,131,0,0
com.cloudera.oryx.common.io.IOUtilsTest.testDistinctFreePorts,random,flaky,131,130,0,1
com.cloudera.oryx.common.io.IOUtilsTest.testDistinctFreePorts,reverse-class,pass,1,1,0,0
com.cloudera.oryx.common.io.IOUtilsTest.testDistinctFreePorts,reverse,pass,1,1,0,0
com.codingchili.TestWriter.shouldWriteToElasticPort,original,flaky,13,9,0,4
com.codingchili.TestWriter.shouldWriteToElasticPort,random,flaky,100,73,0,27
com.espertech.esper.example.rfidassetzone.TestLRMovingSimMain.testSim,original,flaky,61,59,0,2
com.espertech.esper.example.rfidassetzone.TestLRMovingSimMain.testSim,random,flaky,37,36,0,1
com.github.davidmoten.rx2.internal.flowable.FlowableServerSocketTest.testLoad,original,pass,2,2,0,0
com.github.davidmoten.rx2.internal.flowable.FlowableServerSocketTest.testLoad,random,flaky,100,99,0,1
com.github.kagkarlsson.scheduler.compatibility.HsqlCompatibilityTest.test_compatibility,original,pass,2,2,0,0
com.github.kagkarlsson.scheduler.compatibility.HsqlCompatibilityTest.test_compatibility,random,flaky,100,98,0,2
com.github.kagkarlsson.scheduler.SchedulerTest.scheduler_should_execute_rescheduled_task_when_exactly_due,original,pass,2,2,0,0
com.github.kagkarlsson.scheduler.SchedulerTest.scheduler_should_execute_rescheduled_task_when_exactly_due,random,flaky,100,99,0,1
com.github.kagkarlsson.scheduler.WaiterTest.should_wait_until_woken,original,pass,2,2,0,0
com.github.kagkarlsson.scheduler.WaiterTest.should_wait_until_woken,random,flaky,100,98,0,2
com.lcw.one.main.EmailServiceTest.sendEmailList,original,flaky,102,88,0,14
com.lcw.one.main.EmailServiceTest.sendEmailList,random,pass,100,100,0,0
com.marcosbarbero.tests.it.Bucket4jInfinispanApplicationTestIT.testExceedingQuotaCapacityRequest,original,pass,2,2,0,0
com.marcosbarbero.tests.it.Bucket4jInfinispanApplicationTestIT.testExceedingQuotaCapacityRequest,random,flaky,100,99,0,1
com.openpojo.reflection.impl.PojoClassImplTest.shouldCreateInstanceOnAbstract,original,pass,2,2,0,0
com.openpojo.reflection.impl.PojoClassImplTest.shouldCreateInstanceOnAbstract,random,flaky,131,125,0,6
com.oracle.bmc.objectstorage.transfer.ProgressTrackerTest.multipartUploadProgressTrackerFactory_simulateRealLifeScenario,original,flaky,3,2,0,1
com.oracle.bmc.objectstorage.transfer.ProgressTrackerTest.multipartUploadProgressTrackerFactory_simulateRealLifeScenario,random,flaky,200,193,0,7
com.outbrain.aletheia.SampleDomainClassDatumTest.test_avro_route,original,pass,2,2,0,0
com.outbrain.aletheia.SampleDomainClassDatumTest.test_avro_route,random,flaky,100,94,0,6
com.outbrain.aletheia.SampleDomainClassDatumTest.testDatumRoutes,original,pass,2,2,0,0
com.outbrain.aletheia.SampleDomainClassDatumTest.testDatumRoutes,random,flaky,100,95,0,5
com.outbrain.aletheia.SampleDomainClassDatumTest.test_json_route,original,pass,2,2,0,0
com.outbrain.aletheia.SampleDomainClassDatumTest.test_json_route,random,flaky,100,91,0,9
com.outbrain.aletheia.SampleDomainClassDatumTest.test_multiple_routes,original,pass,2,2,0,0
com.outbrain.aletheia.SampleDomainClassDatumTest.test_multiple_routes,random,flaky,100,93,0,7
com.querydsl.hibernate.search.SearchQueryTest.count,original,flaky,14,1,0,13
com.querydsl.hibernate.search.SearchQueryTest.listResults,original,flaky,14,7,0,7
com.querydsl.hibernate.search.SearchQueryTest.paging,original,flaky,14,7,0,7
com.spinn3r.noxy.discovery.zookeeper.ZKTest.testBulkClusterJoining,original,pass,18,18,0,0
com.spinn3r.noxy.discovery.zookeeper.ZKTest.testBulkClusterJoining,random,flaky,89,83,0,6
com.spinn3r.noxy.discovery.zookeeper.ZKTest.testDiscoveryListener,original,flaky,18,7,0,11
com.spinn3r.noxy.discovery.zookeeper.ZKTest.testDiscoveryListener,random,flaky,89,47,0,42
com.spotify.helios.testing.HeliosSoloDeploymentTest.testUndeployLeftoverJobs,original,flaky,25,22,0,3
com.spotify.helios.testing.HeliosSoloDeploymentTest.testUndeployLeftoverJobs,random-class,flaky,71,64,0,7
com.spotify.helios.testing.HeliosSoloDeploymentTest.testUndeployLeftoverJobs,random,flaky,71,67,0,4
com.spotify.helios.testing.HeliosSoloDeploymentTest.testUndeployLeftoverJobs,reverse-class,pass,1,1,0,0
com.spotify.helios.testing.HeliosSoloDeploymentTest.testUndeployLeftoverJobs,reverse,pass,1,1,0,0
com.vmware.admiral.adapter.registry.service.RegistryAdapterServiceProxyTest.testInitWithProxyWithList,original,flaky,4,2,0,2
com.vmware.admiral.adapter.registry.service.RegistryAdapterServiceProxyTest.testInitWithProxyWithList,random,pass,27,27,0,0
com.vmware.admiral.adapter.registry.service.RegistryAdapterServiceTest.testDockerHubListImageTags,original,pass,4,4,0,0
com.vmware.admiral.adapter.registry.service.RegistryAdapterServiceTest.testDockerHubListImageTags,random,flaky,27,26,0,1
com.vmware.admiral.adapter.registry.service.RegistryAdapterServiceTest.testSameRegistryAsGlobalAndProject,original,pass,4,4,0,0
com.vmware.admiral.adapter.registry.service.RegistryAdapterServiceTest.testSameRegistryAsGlobalAndProject,random,flaky,27,26,0,1
com.vmware.admiral.adapter.registry.service.RegistryAdapterServiceTest.testSameRegistryTwoDifferentProjectsNotRemoveOldTenantLinkShouldFail,original,pass,4,4,0,0
com.vmware.admiral.adapter.registry.service.RegistryAdapterServiceTest.testSameRegistryTwoDifferentProjectsNotRemoveOldTenantLinkShouldFail,random,flaky,27,26,0,1
com.vmware.admiral.adapter.registry.service.RegistryAdapterServiceTest.testV1Ping,original,pass,4,4,0,0
com.vmware.admiral.adapter.registry.service.RegistryAdapterServiceTest.testV1Ping,random,flaky,27,26,0,1
delight.nashornsandbox.TestGetFunction.test,original,pass,2,2,0,0
delight.nashornsandbox.TestGetFunction.test,random,flaky,100,99,0,1
delight.nashornsandbox.TestMemoryLimit.test_no_abuse,original,pass,2,2,0,0
delight.nashornsandbox.TestMemoryLimit.test_no_abuse,random,flaky,100,96,0,4
example.sos.modulith.orders.EmailNotificationTest.completingAnOrderUpdatesInventory,original,pass,15,15,0,0
example.sos.modulith.orders.EmailNotificationTest.completingAnOrderUpdatesInventory,random,flaky,110,99,0,11
info.archinnov.achilles.embedded.PortFinderTest.try_to_find_first_port,original,pass,254,254,0,0
info.archinnov.achilles.embedded.PortFinderTest.try_to_find_first_port,random-class,pass,277,277,0,0
info.archinnov.achilles.embedded.PortFinderTest.try_to_find_first_port,random,flaky,278,277,0,1
info.archinnov.achilles.embedded.PortFinderTest.try_to_find_first_port,reverse-class,pass,3,3,0,0
info.archinnov.achilles.embedded.PortFinderTest.try_to_find_first_port,reverse,pass,3,3,0,0
io.dropwizard.logging.DefaultLoggingFactoryTest.testConfigure,original,pass,72,72,0,0
io.dropwizard.logging.DefaultLoggingFactoryTest.testConfigure,random-class,flaky,261,260,0,1
io.dropwizard.logging.DefaultLoggingFactoryTest.testConfigure,random,flaky,248,246,0,2
io.dropwizard.logging.DefaultLoggingFactoryTest.testConfigure,reverse-class,pass,3,3,0,0
io.dropwizard.logging.DefaultLoggingFactoryTest.testConfigure,reverse,pass,3,3,0,0
io.elasticjob.lite.event.rdb.JobEventRdbSearchTest.assertFindJobExecutionEventsWithTime,original,pass,330,330,0,0
io.elasticjob.lite.event.rdb.JobEventRdbSearchTest.assertFindJobExecutionEventsWithTime,random-class,pass,903,903,0,0
io.elasticjob.lite.event.rdb.JobEventRdbSearchTest.assertFindJobExecutionEventsWithTime,random,flaky,815,771,0,44
io.elasticjob.lite.event.rdb.JobEventRdbSearchTest.assertFindJobExecutionEventsWithTime,reverse-class,pass,4,4,0,0
io.elasticjob.lite.event.rdb.JobEventRdbSearchTest.assertFindJobExecutionEventsWithTime,reverse,pass,8,8,0,0
io.elasticjob.lite.lifecycle.api.JobAPIFactoryTest.assertCreateJobStatisticsAPI,original,flaky,283,280,0,3
io.elasticjob.lite.lifecycle.api.JobAPIFactoryTest.assertCreateJobStatisticsAPI,random-class,pass,855,855,0,0
io.elasticjob.lite.lifecycle.api.JobAPIFactoryTest.assertCreateJobStatisticsAPI,random,pass,839,839,0,0
io.elasticjob.lite.lifecycle.api.JobAPIFactoryTest.assertCreateJobStatisticsAPI,reverse-class,pass,4,4,0,0
io.elasticjob.lite.lifecycle.api.JobAPIFactoryTest.assertCreateJobStatisticsAPI,reverse,pass,4,4,0,0
io.elasticjob.lite.lifecycle.api.JobAPIFactoryTest.assertCreateServerStatisticsAPI,original,flaky,284,278,0,6
io.elasticjob.lite.lifecycle.api.JobAPIFactoryTest.assertCreateServerStatisticsAPI,random-class,pass,855,855,0,0
io.elasticjob.lite.lifecycle.api.JobAPIFactoryTest.assertCreateServerStatisticsAPI,random,pass,839,839,0,0
io.elasticjob.lite.lifecycle.api.JobAPIFactoryTest.assertCreateServerStatisticsAPI,reverse-class,pass,4,4,0,0
io.elasticjob.lite.lifecycle.api.JobAPIFactoryTest.assertCreateServerStatisticsAPI,reverse,pass,4,4,0,0
io.elasticjob.lite.spring.job.JobSpringNamespaceWithEventTraceRdbTest.assertSpringJobBean,original,flaky,296,294,0,2
io.elasticjob.lite.spring.job.JobSpringNamespaceWithEventTraceRdbTest.assertSpringJobBean,random-class,pass,850,850,0,0
io.elasticjob.lite.spring.job.JobSpringNamespaceWithEventTraceRdbTest.assertSpringJobBean,random,pass,826,826,0,0
io.elasticjob.lite.spring.job.JobSpringNamespaceWithEventTraceRdbTest.assertSpringJobBean,reverse-class,pass,4,4,0,0
io.elasticjob.lite.spring.job.JobSpringNamespaceWithEventTraceRdbTest.assertSpringJobBean,reverse,pass,4,4,0,0
io.elasticjob.lite.spring.job.JobSpringNamespaceWithListenerAndJdkDynamicProxyTest.assertSpringJobBean,original,flaky,296,295,0,1
io.elasticjob.lite.spring.job.JobSpringNamespaceWithListenerAndJdkDynamicProxyTest.assertSpringJobBean,random-class,pass,850,850,0,0
io.elasticjob.lite.spring.job.JobSpringNamespaceWithListenerAndJdkDynamicProxyTest.assertSpringJobBean,random,pass,826,826,0,0
io.elasticjob.lite.spring.job.JobSpringNamespaceWithListenerAndJdkDynamicProxyTest.assertSpringJobBean,reverse-class,pass,4,4,0,0
io.elasticjob.lite.spring.job.JobSpringNamespaceWithListenerAndJdkDynamicProxyTest.assertSpringJobBean,reverse,pass,4,4,0,0
io.elasticjob.lite.spring.job.JobSpringNamespaceWithoutListenerTest.assertSpringJobBean,original,flaky,297,294,0,3
io.elasticjob.lite.spring.job.JobSpringNamespaceWithoutListenerTest.assertSpringJobBean,random-class,pass,850,850,0,0
io.elasticjob.lite.spring.job.JobSpringNamespaceWithoutListenerTest.assertSpringJobBean,random,flaky,826,825,0,1
io.elasticjob.lite.spring.job.JobSpringNamespaceWithoutListenerTest.assertSpringJobBean,reverse-class,pass,4,4,0,0
io.elasticjob.lite.spring.job.JobSpringNamespaceWithoutListenerTest.assertSpringJobBean,reverse,pass,4,4,0,0
io.logz.sawmill.PipelineExecutorTest.testOnSuccessPipelineExecution,original,pass,2,2,0,0
io.logz.sawmill.PipelineExecutorTest.testOnSuccessPipelineExecution,random,flaky,100,99,0,1
io.logz.sawmill.PipelineExecutorTest.testWarnLongProcessingExecution,original,pass,2,2,0,0
io.logz.sawmill.PipelineExecutorTest.testWarnLongProcessingExecution,random,flaky,100,99,0,1
io.logz.sawmill.processors.ConvertFieldProcessorTest.testConvertToBoolean,original,pass,2,2,0,0
io.logz.sawmill.processors.ConvertFieldProcessorTest.testConvertToBoolean,random,flaky,100,99,0,1
io.undertow.websockets.jsr.test.JsrWebSocketServer07Test.testErrorHandling,original,pass,15,15,0,0
io.undertow.websockets.jsr.test.JsrWebSocketServer07Test.testErrorHandling,random-class,flaky,78,75,0,3
io.undertow.websockets.jsr.test.JsrWebSocketServer07Test.testErrorHandling,random,flaky,65,61,0,4
io.undertow.websockets.jsr.test.JsrWebSocketServer07Test.testErrorHandling,reverse-class,pass,1,1,0,0
io.undertow.websockets.jsr.test.JsrWebSocketServer07Test.testErrorHandling,reverse,pass,1,1,0,0
io.undertow.websockets.jsr.test.JsrWebSocketServer08Test.testErrorHandling,original,pass,15,15,0,0
io.undertow.websockets.jsr.test.JsrWebSocketServer08Test.testErrorHandling,random-class,flaky,78,70,0,8
io.undertow.websockets.jsr.test.JsrWebSocketServer08Test.testErrorHandling,random,flaky,65,59,0,6
io.undertow.websockets.jsr.test.JsrWebSocketServer08Test.testErrorHandling,reverse-class,pass,1,1,0,0
io.undertow.websockets.jsr.test.JsrWebSocketServer08Test.testErrorHandling,reverse,pass,1,1,0,0
io.undertow.websockets.jsr.test.JsrWebSocketServer13Test.testErrorHandling,original,pass,15,15,0,0
io.undertow.websockets.jsr.test.JsrWebSocketServer13Test.testErrorHandling,random-class,flaky,78,76,0,2
io.undertow.websockets.jsr.test.JsrWebSocketServer13Test.testErrorHandling,random,flaky,65,62,0,3
io.undertow.websockets.jsr.test.JsrWebSocketServer13Test.testErrorHandling,reverse-class,pass,1,1,0,0
io.undertow.websockets.jsr.test.JsrWebSocketServer13Test.testErrorHandling,reverse,pass,1,1,0,0
io.undertow.websockets.jsr.test.reconnect.ClientEndpointReconnectTestCase.testAnnotatedClientEndpoint,original,pass,15,15,0,0
io.undertow.websockets.jsr.test.reconnect.ClientEndpointReconnectTestCase.testAnnotatedClientEndpoint,random-class,flaky,78,76,0,2
io.undertow.websockets.jsr.test.reconnect.ClientEndpointReconnectTestCase.testAnnotatedClientEndpoint,random,pass,65,65,0,0
io.undertow.websockets.jsr.test.reconnect.ClientEndpointReconnectTestCase.testAnnotatedClientEndpoint,reverse-class,pass,1,1,0,0
io.undertow.websockets.jsr.test.reconnect.ClientEndpointReconnectTestCase.testAnnotatedClientEndpoint,reverse,pass,1,1,0,0
io.vertx.mqtt.test.server.MqttServerClientIdentifierTest.testValidClientIdentifier,original,pass,2,2,0,0
io.vertx.mqtt.test.server.MqttServerClientIdentifierTest.testValidClientIdentifier,random,flaky,100,99,0,1
io.vertx.mqtt.test.server.MqttServerClientPublishTest.publishQos0,original,pass,2,2,0,0
io.vertx.mqtt.test.server.MqttServerClientPublishTest.publishQos0,random,flaky,100,99,0,1
io.vertx.mqtt.test.server.MqttServerConnectionTest.accepted,original,pass,2,2,0,0
io.vertx.mqtt.test.server.MqttServerConnectionTest.accepted,random,flaky,100,99,0,1
io.vertx.mqtt.test.server.MqttServerConnectionTest.connectionAlreadyAccepted,original,pass,2,2,0,0
io.vertx.mqtt.test.server.MqttServerConnectionTest.connectionAlreadyAccepted,random,flaky,100,98,0,2
io.vertx.mqtt.test.server.MqttServerConnectionTest.noConnectSent,original,pass,2,2,0,0
io.vertx.mqtt.test.server.MqttServerConnectionTest.noConnectSent,random,flaky,100,97,0,3
io.vertx.mqtt.test.server.MqttServerUnsubscribeTest.unsubscribe,original,pass,2,2,0,0
io.vertx.mqtt.test.server.MqttServerUnsubscribeTest.unsubscribe,random,flaky,100,99,0,1
io.vertx.rabbitmq.RabbitMQClientReconnectTest.testReconnect,original,pass,4,4,0,0
io.vertx.rabbitmq.RabbitMQClientReconnectTest.testReconnect,random,flaky,100,97,0,3
io.vertx.rabbitmq.RabbitMQConsumptionStreamingTest.keepMostRecentOptionShouldWorks,original,pass,4,4,0,0
io.vertx.rabbitmq.RabbitMQConsumptionStreamingTest.keepMostRecentOptionShouldWorks,random,flaky,100,99,0,1
io.vertx.rabbitmq.RabbitMQConsumptionStreamingTest.pauseAndResumeShouldWork,original,flaky,4,3,0,1
io.vertx.rabbitmq.RabbitMQConsumptionStreamingTest.pauseAndResumeShouldWork,random,flaky,100,78,0,22
io.vertx.rabbitmq.RabbitMQServiceTest.testBasicCancel,original,pass,4,4,0,0
io.vertx.rabbitmq.RabbitMQServiceTest.testBasicCancel,random,flaky,100,99,0,1
io.vertx.rabbitmq.RabbitMQServiceTest.testBasicConsume,original,pass,4,4,0,0
io.vertx.rabbitmq.RabbitMQServiceTest.testBasicConsume,random,flaky,100,98,0,2
io.vertx.rabbitmq.RabbitMQServiceTest.testGetMessageCount,original,pass,4,4,0,0
io.vertx.rabbitmq.RabbitMQServiceTest.testGetMessageCount,random,flaky,100,99,0,1
io.vertx.rabbitmq.RabbitMQServiceTest.testMessageOrderingWhenConsumingNewApi,original,flaky,4,3,0,1
io.vertx.rabbitmq.RabbitMQServiceTest.testMessageOrderingWhenConsumingNewApi,random,flaky,100,95,0,5
io.yawp.testing.appengine.pipes.flow.FlowDropsTest.testFlowDropsToSameSink,original,flaky,204,202,0,2
io.yawp.testing.appengine.pipes.flow.FlowDropsTest.testFlowDropsToSameSink,random,flaky,100,98,0,2
me.escoffier.vertx.completablefuture.VertxCompletableFutureTest.testAcceptEitherAsyncWithExecutor,original,pass,2,2,0,0
me.escoffier.vertx.completablefuture.VertxCompletableFutureTest.testAcceptEitherAsyncWithExecutor,random,flaky,100,99,0,1
net.redpipe.discovery.DiscoveryTest.checkWebClient,original,pass,23,23,0,0
net.redpipe.discovery.DiscoveryTest.checkWebClient,random,flaky,48,46,0,2
net.redpipe.engine.swagger.SwaggerApiTest.checkSwagger,original,flaky,3,1,0,2
net.redpipe.engine.swagger.SwaggerApiTest.checkSwagger,random,pass,100,100,0,0
net.redpipe.templating.freemarker.ApiTest.checkMail,original,pass,2,2,0,0
net.redpipe.templating.freemarker.ApiTest.checkMail,random,flaky,20,19,0,1
net.redpipe.templating.freemarker.ApiTest.checkTemplateNegociationSingleHtml,original,flaky,2,1,0,1
net.redpipe.templating.freemarker.ApiTest.checkTemplateNegociationSingleHtml,random,pass,20,20,0,0
net.redpipe.templating.freemarker.ApiTest.checkTemplateNegociationText,original,pass,2,2,0,0
net.redpipe.templating.freemarker.ApiTest.checkTemplateNegociationText,random,flaky,20,13,0,7
org.apache.dubbo.remoting.exchange.support.header.HeartbeatHandlerTest.testHeartbeat,original,pass,23,23,0,0
org.apache.dubbo.remoting.exchange.support.header.HeartbeatHandlerTest.testHeartbeat,random-class,flaky,79,78,0,1
org.apache.dubbo.remoting.exchange.support.header.HeartbeatHandlerTest.testHeartbeat,random,pass,53,53,0,0
org.apache.dubbo.remoting.exchange.support.header.HeartbeatHandlerTest.testHeartbeat,reverse-class,pass,3,3,0,0
org.apache.dubbo.remoting.exchange.support.header.HeartbeatHandlerTest.testHeartbeat,reverse,pass,3,3,0,0
org.apache.dubbo.rpc.protocol.dubbo.DubboLazyConnectTest.testSticky1,original,pass,23,23,0,0
org.apache.dubbo.rpc.protocol.dubbo.DubboLazyConnectTest.testSticky1,random-class,flaky,72,71,0,1
org.apache.dubbo.rpc.protocol.dubbo.DubboLazyConnectTest.testSticky1,random,pass,76,76,0,0
org.apache.dubbo.rpc.protocol.dubbo.DubboLazyConnectTest.testSticky1,reverse-class,pass,3,3,0,0
org.apache.dubbo.rpc.protocol.dubbo.DubboLazyConnectTest.testSticky1,reverse,pass,6,6,0,0
org.apache.dubbo.rpc.protocol.dubbo.DubboProtocolTest.testDemoProtocol,original,pass,23,23,0,0
org.apache.dubbo.rpc.protocol.dubbo.DubboProtocolTest.testDemoProtocol,random-class,flaky,72,71,0,1
org.apache.dubbo.rpc.protocol.dubbo.DubboProtocolTest.testDemoProtocol,random,pass,76,76,0,0
org.apache.dubbo.rpc.protocol.dubbo.DubboProtocolTest.testDemoProtocol,reverse-class,pass,3,3,0,0
org.apache.dubbo.rpc.protocol.dubbo.DubboProtocolTest.testDemoProtocol,reverse,pass,6,6,0,0
org.apache.dubbo.rpc.protocol.dubbo.DubboProtocolTest.testNonSerializedParameter,original,pass,23,23,0,0
org.apache.dubbo.rpc.protocol.dubbo.DubboProtocolTest.testNonSerializedParameter,random-class,flaky,72,71,0,1
org.apache.dubbo.rpc.protocol.dubbo.DubboProtocolTest.testNonSerializedParameter,random,pass,76,76,0,0
org.apache.dubbo.rpc.protocol.dubbo.DubboProtocolTest.testNonSerializedParameter,reverse-class,pass,3,3,0,0
org.apache.dubbo.rpc.protocol.dubbo.DubboProtocolTest.testNonSerializedParameter,reverse,pass,6,6,0,0
org.apache.dubbo.rpc.protocol.dubbo.DubboProtocolTest.testPerm,original,pass,23,23,0,0
org.apache.dubbo.rpc.protocol.dubbo.DubboProtocolTest.testPerm,random-class,flaky,72,71,0,1
org.apache.dubbo.rpc.protocol.dubbo.DubboProtocolTest.testPerm,random,pass,76,76,0,0
org.apache.dubbo.rpc.protocol.dubbo.DubboProtocolTest.testPerm,reverse-class,pass,3,3,0,0
org.apache.dubbo.rpc.protocol.dubbo.DubboProtocolTest.testPerm,reverse,pass,6,6,0,0
org.apache.dubbo.rpc.protocol.dubbo.DubboProtocolTest.testReturnNonSerialized,original,pass,23,23,0,0
org.apache.dubbo.rpc.protocol.dubbo.DubboProtocolTest.testReturnNonSerialized,random-class,flaky,72,71,0,1
org.apache.dubbo.rpc.protocol.dubbo.DubboProtocolTest.testReturnNonSerialized,random,pass,76,76,0,0
org.apache.dubbo.rpc.protocol.dubbo.DubboProtocolTest.testReturnNonSerialized,reverse-class,pass,3,3,0,0
org.apache.dubbo.rpc.protocol.dubbo.DubboProtocolTest.testReturnNonSerialized,reverse,pass,6,6,0,0
org.apache.dubbo.rpc.protocol.dubbo.MultiThreadTest.testDubboMultiThreadInvoke,original,pass,23,23,0,0
org.apache.dubbo.rpc.protocol.dubbo.MultiThreadTest.testDubboMultiThreadInvoke,random-class,flaky,72,71,0,1
org.apache.dubbo.rpc.protocol.dubbo.MultiThreadTest.testDubboMultiThreadInvoke,random,pass,76,76,0,0
org.apache.dubbo.rpc.protocol.dubbo.MultiThreadTest.testDubboMultiThreadInvoke,reverse-class,pass,3,3,0,0
org.apache.dubbo.rpc.protocol.dubbo.MultiThreadTest.testDubboMultiThreadInvoke,reverse,pass,6,6,0,0
org.apache.dubbo.rpc.protocol.dubbo.telnet.ChangeTelnetHandlerTest.testChangePath,original,pass,23,23,0,0
org.apache.dubbo.rpc.protocol.dubbo.telnet.ChangeTelnetHandlerTest.testChangePath,random-class,flaky,72,71,0,1
org.apache.dubbo.rpc.protocol.dubbo.telnet.ChangeTelnetHandlerTest.testChangePath,random,pass,76,76,0,0
org.apache.dubbo.rpc.protocol.dubbo.telnet.ChangeTelnetHandlerTest.testChangePath,reverse-class,pass,3,3,0,0
org.apache.dubbo.rpc.protocol.dubbo.telnet.ChangeTelnetHandlerTest.testChangePath,reverse,pass,6,6,0,0
org.apache.dubbo.rpc.protocol.dubbo.telnet.ListTelnetHandlerTest.testList,original,pass,23,23,0,0
org.apache.dubbo.rpc.protocol.dubbo.telnet.ListTelnetHandlerTest.testList,random-class,pass,72,72,0,0
org.apache.dubbo.rpc.protocol.dubbo.telnet.ListTelnetHandlerTest.testList,random,flaky,76,75,0,1
org.apache.dubbo.rpc.protocol.dubbo.telnet.ListTelnetHandlerTest.testList,reverse-class,pass,3,3,0,0
org.apache.dubbo.rpc.protocol.dubbo.telnet.ListTelnetHandlerTest.testList,reverse,pass,6,6,0,0
org.apache.dubbo.rpc.protocol.dubbo.telnet.ListTelnetHandlerTest.testListService,original,pass,23,23,0,0
org.apache.dubbo.rpc.protocol.dubbo.telnet.ListTelnetHandlerTest.testListService,random-class,pass,72,72,0,0
org.apache.dubbo.rpc.protocol.dubbo.telnet.ListTelnetHandlerTest.testListService,random,flaky,76,74,0,2
org.apache.dubbo.rpc.protocol.dubbo.telnet.ListTelnetHandlerTest.testListService,reverse-class,pass,3,3,0,0
org.apache.dubbo.rpc.protocol.dubbo.telnet.ListTelnetHandlerTest.testListService,reverse,pass,6,6,0,0
org.apache.dubbo.rpc.protocol.http.HttpProtocolTest.testGenericInvokeWithNativeJava,original,flaky,70,69,0,1
org.apache.dubbo.rpc.protocol.http.HttpProtocolTest.testGenericInvokeWithNativeJava,random-class,pass,92,92,0,0
org.apache.dubbo.rpc.protocol.http.HttpProtocolTest.testGenericInvokeWithNativeJava,random,pass,49,49,0,0
org.apache.dubbo.rpc.protocol.http.HttpProtocolTest.testGenericInvokeWithNativeJava,reverse-class,pass,3,3,0,0
org.apache.dubbo.rpc.protocol.http.HttpProtocolTest.testGenericInvokeWithNativeJava,reverse,pass,3,3,0,0
org.apache.dubbo.rpc.protocol.http.HttpProtocolTest.testTimeOut,original,flaky,70,69,0,1
org.apache.dubbo.rpc.protocol.http.HttpProtocolTest.testTimeOut,random-class,pass,92,92,0,0
org.apache.dubbo.rpc.protocol.http.HttpProtocolTest.testTimeOut,random,pass,49,49,0,0
org.apache.dubbo.rpc.protocol.http.HttpProtocolTest.testTimeOut,reverse-class,pass,3,3,0,0
org.apache.dubbo.rpc.protocol.http.HttpProtocolTest.testTimeOut,reverse,pass,3,3,0,0
org.apache.hadoop.fs.http.server.TestHttpFSServer.testAllowSnapshot,original,pass,7,7,0,0
org.apache.hadoop.fs.http.server.TestHttpFSServer.testAllowSnapshot,random-class,pass,13,13,0,0
org.apache.hadoop.fs.http.server.TestHttpFSServer.testAllowSnapshot,random,pass,14,14,0,0
org.apache.hadoop.fs.http.server.TestHttpFSServer.testAllowSnapshot,reverse-class,flaky,2,1,0,1
org.apache.hadoop.fs.http.server.TestHttpFSServer.testCreateSnapshot,original,pass,7,7,0,0
org.apache.hadoop.fs.http.server.TestHttpFSServer.testCreateSnapshot,random-class,pass,13,13,0,0
org.apache.hadoop.fs.http.server.TestHttpFSServer.testCreateSnapshot,random,pass,14,14,0,0
org.apache.hadoop.fs.http.server.TestHttpFSServer.testCreateSnapshot,reverse-class,flaky,2,1,0,1
org.apache.hadoop.fs.http.server.TestHttpFSServer.testDelegationTokenOperationsSsl,original,pass,7,7,0,0
org.apache.hadoop.fs.http.server.TestHttpFSServer.testDelegationTokenOperationsSsl,random-class,pass,13,13,0,0
org.apache.hadoop.fs.http.server.TestHttpFSServer.testDelegationTokenOperationsSsl,random,pass,14,14,0,0
org.apache.hadoop.fs.http.server.TestHttpFSServer.testDelegationTokenOperationsSsl,reverse-class,flaky,2,1,0,1
org.apache.hadoop.fs.http.server.TestHttpFSServer.testDirAcls,original,pass,7,7,0,0
org.apache.hadoop.fs.http.server.TestHttpFSServer.testDirAcls,random-class,pass,13,13,0,0
org.apache.hadoop.fs.http.server.TestHttpFSServer.testDirAcls,random,pass,14,14,0,0
org.apache.hadoop.fs.http.server.TestHttpFSServer.testDirAcls,reverse-class,flaky,2,1,0,1
org.apache.hadoop.fs.http.server.TestHttpFSServer.testDisallowSnapshotException,original,pass,7,7,0,0
org.apache.hadoop.fs.http.server.TestHttpFSServer.testDisallowSnapshotException,random-class,pass,13,13,0,0
org.apache.hadoop.fs.http.server.TestHttpFSServer.testDisallowSnapshotException,random,pass,14,14,0,0
org.apache.hadoop.fs.http.server.TestHttpFSServer.testDisallowSnapshotException,reverse-class,flaky,2,1,0,1
org.apache.hadoop.fs.http.server.TestHttpFSServer.testDisallowSnapshot,original,pass,7,7,0,0
org.apache.hadoop.fs.http.server.TestHttpFSServer.testDisallowSnapshot,random-class,pass,13,13,0,0
org.apache.hadoop.fs.http.server.TestHttpFSServer.testDisallowSnapshot,random,pass,14,14,0,0
org.apache.hadoop.fs.http.server.TestHttpFSServer.testDisallowSnapshot,reverse-class,flaky,2,1,0,1
org.apache.hadoop.fs.http.server.TestHttpFSServer.testGetSnapshotDiffIllegalParam,original,pass,7,7,0,0
org.apache.hadoop.fs.http.server.TestHttpFSServer.testGetSnapshotDiffIllegalParam,random-class,pass,13,13,0,0
org.apache.hadoop.fs.http.server.TestHttpFSServer.testGetSnapshotDiffIllegalParam,random,pass,14,14,0,0
org.apache.hadoop.fs.http.server.TestHttpFSServer.testGetSnapshotDiffIllegalParam,reverse-class,flaky,2,1,0,1
org.apache.hadoop.hbase.procedure2.TestProcedureSkipPersistence.test,original,flaky,6,5,0,1
org.apache.hadoop.hbase.procedure2.TestProcedureSkipPersistence.test,random-class,pass,14,14,0,0
org.apache.hadoop.hbase.procedure2.TestProcedureSkipPersistence.test,random,flaky,13,12,0,1
org.apache.hadoop.hbase.procedure2.TestProcedureSkipPersistence.test,reverse-class,pass,1,1,0,0
org.apache.hadoop.hbase.procedure2.TestProcedureSkipPersistence.test,reverse,flaky,2,1,0,1
org.apache.hadoop.lib.service.hadoop.TestFileSystemAccessService.fileSystemCache,original,pass,7,7,0,0
org.apache.hadoop.lib.service.hadoop.TestFileSystemAccessService.fileSystemCache,random-class,pass,13,13,0,0
org.apache.hadoop.lib.service.hadoop.TestFileSystemAccessService.fileSystemCache,random,pass,14,14,0,0
org.apache.hadoop.lib.service.hadoop.TestFileSystemAccessService.fileSystemCache,reverse-class,flaky,2,1,0,1
org.apache.hadoop.lib.service.hadoop.TestFileSystemAccessService.fileSystemExecutor,original,pass,7,7,0,0
org.apache.hadoop.lib.service.hadoop.TestFileSystemAccessService.fileSystemExecutor,random-class,pass,13,13,0,0
org.apache.hadoop.lib.service.hadoop.TestFileSystemAccessService.fileSystemExecutor,random,pass,14,14,0,0
org.apache.hadoop.lib.service.hadoop.TestFileSystemAccessService.fileSystemExecutor,reverse-class,flaky,2,1,0,1
org.apache.hadoop.lib.servlet.TestServerWebApp.getHomeDirNotDef,original,pass,7,7,0,0
org.apache.hadoop.lib.servlet.TestServerWebApp.getHomeDirNotDef,random-class,pass,13,13,0,0
org.apache.hadoop.lib.servlet.TestServerWebApp.getHomeDirNotDef,random,pass,14,14,0,0
org.apache.hadoop.lib.servlet.TestServerWebApp.getHomeDirNotDef,reverse-class,flaky,2,1,0,1
org.apache.hadoop.registry.client.impl.TestCuratorService.testRM,original,pass,7,7,0,0
org.apache.hadoop.registry.client.impl.TestCuratorService.testRM,random-class,pass,6,6,0,0
org.apache.hadoop.registry.client.impl.TestCuratorService.testRM,random,pass,14,14,0,0
org.apache.hadoop.registry.client.impl.TestCuratorService.testRM,reverse-class,pass,1,1,0,0
org.apache.hadoop.registry.client.impl.TestCuratorService.testRM,reverse,flaky,3,2,0,1
org.apache.hadoop.registry.secure.TestSecureLogins.testDefaultRealmValid,original,pass,7,7,0,0
org.apache.hadoop.registry.secure.TestSecureLogins.testDefaultRealmValid,random-class,pass,6,6,0,0
org.apache.hadoop.registry.secure.TestSecureLogins.testDefaultRealmValid,random,pass,14,14,0,0
org.apache.hadoop.registry.secure.TestSecureLogins.testDefaultRealmValid,reverse-class,pass,1,1,0,0
org.apache.hadoop.registry.secure.TestSecureLogins.testDefaultRealmValid,reverse,flaky,3,2,0,1
org.apache.hadoop.registry.secure.TestSecureLogins.testUGILogin,original,pass,7,7,0,0
org.apache.hadoop.registry.secure.TestSecureLogins.testUGILogin,random-class,pass,6,6,0,0
org.apache.hadoop.registry.secure.TestSecureLogins.testUGILogin,random,pass,14,14,0,0
org.apache.hadoop.registry.secure.TestSecureLogins.testUGILogin,reverse-class,pass,1,1,0,0
org.apache.hadoop.registry.secure.TestSecureLogins.testUGILogin,reverse,flaky,3,2,0,1
org.apache.hadoop.yarn.server.timelineservice.reader.TestTimelineReaderWebServices.testGetEntityDefaultView,original,pass,8,8,0,0
org.apache.hadoop.yarn.server.timelineservice.reader.TestTimelineReaderWebServices.testGetEntityDefaultView,random-class,flaky,7,4,0,3
org.apache.hadoop.yarn.server.timelineservice.reader.TestTimelineReaderWebServices.testGetEntityDefaultView,random,flaky,7,4,0,3
org.apache.hadoop.yarn.server.timeline.TestEntityGroupFSTimelineStore.testGetEntityPluginRead,original,flaky,9,7,0,2
org.apache.hadoop.yarn.server.timeline.TestEntityGroupFSTimelineStore.testGetEntityPluginRead,random-class,pass,6,6,0,0
org.apache.hadoop.yarn.server.timeline.TestEntityGroupFSTimelineStore.testGetEntityPluginRead,random,pass,14,14,0,0
org.apache.hadoop.yarn.server.timeline.TestEntityGroupFSTimelineStore.testGetEntityPluginRead,reverse-class,pass,1,1,0,0
org.apache.hadoop.yarn.server.timeline.TestEntityGroupFSTimelineStore.testGetEntityPluginRead,reverse,pass,3,3,0,0
org.apache.hadoop.yarn.server.timeline.TestEntityGroupFSTimelineStore.testMoveToDone,original,pass,7,7,0,0
org.apache.hadoop.yarn.server.timeline.TestEntityGroupFSTimelineStore.testMoveToDone,random-class,pass,6,6,0,0
org.apache.hadoop.yarn.server.timeline.TestEntityGroupFSTimelineStore.testMoveToDone,random,pass,14,14,0,0
org.apache.hadoop.yarn.server.timeline.TestEntityGroupFSTimelineStore.testMoveToDone,reverse-class,pass,1,1,0,0
org.apache.hadoop.yarn.server.timeline.TestEntityGroupFSTimelineStore.testMoveToDone,reverse,flaky,3,2,0,1
org.apache.hadoop.yarn.server.timeline.TestEntityGroupFSTimelineStore.testParseSummaryLogs,original,pass,7,7,0,0
org.apache.hadoop.yarn.server.timeline.TestEntityGroupFSTimelineStore.testParseSummaryLogs,random-class,pass,6,6,0,0
org.apache.hadoop.yarn.server.timeline.TestEntityGroupFSTimelineStore.testParseSummaryLogs,random,pass,14,14,0,0
org.apache.hadoop.yarn.server.timeline.TestEntityGroupFSTimelineStore.testParseSummaryLogs,reverse-class,pass,1,1,0,0
org.apache.hadoop.yarn.server.timeline.TestEntityGroupFSTimelineStore.testParseSummaryLogs,reverse,flaky,3,2,0,1
org.apache.hadoop.yarn.server.timeline.TestLogInfo.testParseBrokenEntity,original,pass,7,7,0,0
org.apache.hadoop.yarn.server.timeline.TestLogInfo.testParseBrokenEntity,random-class,pass,6,6,0,0
org.apache.hadoop.yarn.server.timeline.TestLogInfo.testParseBrokenEntity,random,pass,14,14,0,0
org.apache.hadoop.yarn.server.timeline.TestLogInfo.testParseBrokenEntity,reverse-class,pass,1,1,0,0
org.apache.hadoop.yarn.server.timeline.TestLogInfo.testParseBrokenEntity,reverse,flaky,3,1,0,2
org.apache.hadoop.yarn.server.timeline.TestLogInfo.testParseEntity,original,pass,7,7,0,0
org.apache.hadoop.yarn.server.timeline.TestLogInfo.testParseEntity,random-class,pass,6,6,0,0
org.apache.hadoop.yarn.server.timeline.TestLogInfo.testParseEntity,random,pass,14,14,0,0
org.apache.hadoop.yarn.server.timeline.TestLogInfo.testParseEntity,reverse-class,pass,1,1,0,0
org.apache.hadoop.yarn.server.timeline.TestLogInfo.testParseEntity,reverse,flaky,3,2,0,1
org.fluentd.logger.TestFluentLogger.testReconnection,original,pass,2,2,0,0
org.fluentd.logger.TestFluentLogger.testReconnection,random,flaky,100,99,0,1
org.glassfish.tyrus.test.e2e.non_deployable.ServerExecutorsManagementTest.testExecutorServicesGetClosed,original,flaky,4,1,0,3
org.jasig.cas.client.validation.AssertionImplTests.testAssertionValidity,original,pass,2,2,0,0
org.jasig.cas.client.validation.AssertionImplTests.testAssertionValidity,random,flaky,100,99,0,1
org.java_websocket.issues.Issue256Test.runReconnectBlockingScenario0,original,flaky,666,661,0,5
org.java_websocket.issues.Issue256Test.runReconnectBlockingScenario0,random-class,flaky,1653,1620,0,33
org.java_websocket.issues.Issue256Test.runReconnectBlockingScenario0,random,flaky,1653,1625,0,28
org.java_websocket.issues.Issue256Test.runReconnectBlockingScenario0,reverse-class,pass,1,1,0,0
org.java_websocket.issues.Issue256Test.runReconnectBlockingScenario0,reverse,pass,1,1,0,0
org.java_websocket.issues.Issue256Test.runReconnectBlockingScenario1,original,flaky,666,663,0,3
org.java_websocket.issues.Issue256Test.runReconnectBlockingScenario1,random-class,flaky,1653,1625,0,28
org.java_websocket.issues.Issue256Test.runReconnectBlockingScenario1,random,flaky,1653,1622,0,31
org.java_websocket.issues.Issue256Test.runReconnectBlockingScenario1,reverse-class,pass,1,1,0,0
org.java_websocket.issues.Issue256Test.runReconnectBlockingScenario1,reverse,pass,1,1,0,0
org.java_websocket.issues.Issue256Test.runReconnectBlockingScenario2,original,flaky,666,661,0,5
org.java_websocket.issues.Issue256Test.runReconnectBlockingScenario2,random-class,flaky,1653,1628,0,25
org.java_websocket.issues.Issue256Test.runReconnectBlockingScenario2,random,flaky,1653,1624,0,29
org.java_websocket.issues.Issue256Test.runReconnectBlockingScenario2,reverse-class,pass,1,1,0,0
org.java_websocket.issues.Issue256Test.runReconnectBlockingScenario2,reverse,pass,1,1,0,0
org.java_websocket.issues.Issue256Test.runReconnectBlockingScenario3,original,flaky,666,660,0,6
org.java_websocket.issues.Issue256Test.runReconnectBlockingScenario3,random-class,flaky,1653,1625,0,28
org.java_websocket.issues.Issue256Test.runReconnectBlockingScenario3,random,flaky,1653,1617,0,36
org.java_websocket.issues.Issue256Test.runReconnectBlockingScenario3,reverse-class,pass,1,1,0,0
org.java_websocket.issues.Issue256Test.runReconnectBlockingScenario3,reverse,pass,1,1,0,0
org.java_websocket.issues.Issue256Test.runReconnectBlockingScenario4,original,flaky,666,663,0,3
org.java_websocket.issues.Issue256Test.runReconnectBlockingScenario4,random-class,flaky,1653,1624,0,29
org.java_websocket.issues.Issue256Test.runReconnectBlockingScenario4,random,flaky,1653,1625,0,28
org.java_websocket.issues.Issue256Test.runReconnectBlockingScenario4,reverse-class,pass,1,1,0,0
org.java_websocket.issues.Issue256Test.runReconnectBlockingScenario4,reverse,pass,1,1,0,0
org.java_websocket.issues.Issue256Test.runReconnectBlockingScenario5,original,flaky,666,662,0,4
org.java_websocket.issues.Issue256Test.runReconnectBlockingScenario5,random-class,flaky,1653,1628,0,25
org.java_websocket.issues.Issue256Test.runReconnectBlockingScenario5,random,flaky,1653,1621,0,32
org.java_websocket.issues.Issue256Test.runReconnectBlockingScenario5,reverse-class,pass,1,1,0,0
org.java_websocket.issues.Issue256Test.runReconnectBlockingScenario5,reverse,pass,1,1,0,0
org.java_websocket.issues.Issue256Test.runReconnectBlockingScenario6,original,pass,666,666,0,0
org.java_websocket.issues.Issue256Test.runReconnectBlockingScenario6,random-class,flaky,1653,1629,0,24
org.java_websocket.issues.Issue256Test.runReconnectBlockingScenario6,random,flaky,1653,1623,0,30
org.java_websocket.issues.Issue256Test.runReconnectBlockingScenario6,reverse-class,pass,1,1,0,0
org.java_websocket.issues.Issue256Test.runReconnectBlockingScenario6,reverse,pass,1,1,0,0
org.java_websocket.issues.Issue256Test.runReconnectBlockingScenario7,original,flaky,666,661,0,5
org.java_websocket.issues.Issue256Test.runReconnectBlockingScenario7,random-class,flaky,1653,1625,0,28
org.java_websocket.issues.Issue256Test.runReconnectBlockingScenario7,random,flaky,1653,1614,0,39
org.java_websocket.issues.Issue256Test.runReconnectBlockingScenario7,reverse-class,pass,1,1,0,0
org.java_websocket.issues.Issue256Test.runReconnectBlockingScenario7,reverse,pass,1,1,0,0
org.java_websocket.issues.Issue256Test.runReconnectBlockingScenario8,original,flaky,666,659,0,7
org.java_websocket.issues.Issue256Test.runReconnectBlockingScenario8,random-class,flaky,1653,1625,0,28
org.java_websocket.issues.Issue256Test.runReconnectBlockingScenario8,random,flaky,1653,1621,0,32
org.java_websocket.issues.Issue256Test.runReconnectBlockingScenario8,reverse-class,pass,1,1,0,0
org.java_websocket.issues.Issue256Test.runReconnectBlockingScenario8,reverse,pass,1,1,0,0
org.java_websocket.issues.Issue256Test.runReconnectBlockingScenario9,original,flaky,666,658,0,8
org.java_websocket.issues.Issue256Test.runReconnectBlockingScenario9,random-class,flaky,1653,1622,0,31
org.java_websocket.issues.Issue256Test.runReconnectBlockingScenario9,random,flaky,1653,1622,0,31
org.java_websocket.issues.Issue256Test.runReconnectBlockingScenario9,reverse-class,pass,1,1,0,0
org.java_websocket.issues.Issue256Test.runReconnectBlockingScenario9,reverse,pass,1,1,0,0
org.java_websocket.issues.Issue256Test.runReconnectScenario0,original,flaky,666,660,0,6
org.java_websocket.issues.Issue256Test.runReconnectScenario0,random-class,flaky,1653,1560,0,93
org.java_websocket.issues.Issue256Test.runReconnectScenario0,random,flaky,1653,1604,0,49
org.java_websocket.issues.Issue256Test.runReconnectScenario0,reverse-class,pass,1,1,0,0
org.java_websocket.issues.Issue256Test.runReconnectScenario0,reverse,pass,1,1,0,0
org.java_websocket.issues.Issue256Test.runReconnectScenario1,original,flaky,666,645,0,21
org.java_websocket.issues.Issue256Test.runReconnectScenario1,random-class,flaky,1653,1599,0,54
org.java_websocket.issues.Issue256Test.runReconnectScenario1,random,flaky,1653,1613,0,40
org.java_websocket.issues.Issue256Test.runReconnectScenario1,reverse-class,pass,1,1,0,0
org.java_websocket.issues.Issue256Test.runReconnectScenario1,reverse,pass,1,1,0,0
org.java_websocket.issues.Issue256Test.runReconnectScenario2,original,flaky,666,664,0,2
org.java_websocket.issues.Issue256Test.runReconnectScenario2,random-class,flaky,1653,1582,0,71
org.java_websocket.issues.Issue256Test.runReconnectScenario2,random,flaky,1653,1610,0,43
org.java_websocket.issues.Issue256Test.runReconnectScenario2,reverse-class,pass,1,1,0,0
org.java_websocket.issues.Issue256Test.runReconnectScenario2,reverse,pass,1,1,0,0
org.java_websocket.issues.Issue256Test.runReconnectScenario3,original,flaky,666,663,0,3
org.java_websocket.issues.Issue256Test.runReconnectScenario3,random-class,flaky,1653,1580,0,73
org.java_websocket.issues.Issue256Test.runReconnectScenario3,random,flaky,1653,1608,0,45
org.java_websocket.issues.Issue256Test.runReconnectScenario3,reverse-class,pass,1,1,0,0
org.java_websocket.issues.Issue256Test.runReconnectScenario3,reverse,failure,1,0,0,1
org.java_websocket.issues.Issue256Test.runReconnectScenario4,original,flaky,666,665,0,1
org.java_websocket.issues.Issue256Test.runReconnectScenario4,random-class,flaky,1653,1588,0,65
org.java_websocket.issues.Issue256Test.runReconnectScenario4,random,flaky,1653,1619,0,34
org.java_websocket.issues.Issue256Test.runReconnectScenario4,reverse-class,pass,1,1,0,0
org.java_websocket.issues.Issue256Test.runReconnectScenario4,reverse,pass,1,1,0,0
org.java_websocket.issues.Issue256Test.runReconnectScenario5,original,flaky,666,661,0,5
org.java_websocket.issues.Issue256Test.runReconnectScenario5,random-class,flaky,1653,1596,0,57
org.java_websocket.issues.Issue256Test.runReconnectScenario5,random,flaky,1653,1613,0,40
org.java_websocket.issues.Issue256Test.runReconnectScenario5,reverse-class,pass,1,1,0,0
org.java_websocket.issues.Issue256Test.runReconnectScenario5,reverse,pass,1,1,0,0
org.java_websocket.issues.Issue256Test.runReconnectScenario6,original,pass,666,666,0,0
org.java_websocket.issues.Issue256Test.runReconnectScenario6,random-class,flaky,1653,1608,0,45
org.java_websocket.issues.Issue256Test.runReconnectScenario6,random,flaky,1653,1607,0,46
org.java_websocket.issues.Issue256Test.runReconnectScenario6,reverse-class,pass,1,1,0,0
org.java_websocket.issues.Issue256Test.runReconnectScenario6,reverse,pass,1,1,0,0
org.java_websocket.issues.Issue256Test.runReconnectScenario7,original,flaky,666,662,0,4
org.java_websocket.issues.Issue256Test.runReconnectScenario7,random-class,flaky,1653,1618,0,35
org.java_websocket.issues.Issue256Test.runReconnectScenario7,random,flaky,1653,1610,0,43
org.java_websocket.issues.Issue256Test.runReconnectScenario7,reverse-class,pass,1,1,0,0
org.java_websocket.issues.Issue256Test.runReconnectScenario7,reverse,pass,1,1,0,0
org.java_websocket.issues.Issue256Test.runReconnectScenario8,original,flaky,666,663,0,3
org.java_websocket.issues.Issue256Test.runReconnectScenario8,random-class,flaky,1653,1629,0,24
org.java_websocket.issues.Issue256Test.runReconnectScenario8,random,flaky,1653,1615,0,38
org.java_websocket.issues.Issue256Test.runReconnectScenario8,reverse-class,pass,1,1,0,0
org.java_websocket.issues.Issue256Test.runReconnectScenario8,reverse,pass,1,1,0,0
org.java_websocket.issues.Issue256Test.runReconnectScenario9,original,flaky,666,665,0,1
org.java_websocket.issues.Issue256Test.runReconnectScenario9,random-class,flaky,1653,1620,0,33
org.java_websocket.issues.Issue256Test.runReconnectScenario9,random,flaky,1653,1605,0,48
org.java_websocket.issues.Issue256Test.runReconnectScenario9,reverse-class,pass,1,1,0,0
org.java_websocket.issues.Issue256Test.runReconnectScenario9,reverse,pass,1,1,0,0
org.java_websocket.issues.Issue580Test.runNoCloseBlockingTestScenario0,original,pass,666,666,0,0
org.java_websocket.issues.Issue580Test.runNoCloseBlockingTestScenario0,random-class,flaky,1653,1652,0,1
org.java_websocket.issues.Issue580Test.runNoCloseBlockingTestScenario0,random,pass,1653,1653,0,0
org.java_websocket.issues.Issue580Test.runNoCloseBlockingTestScenario0,reverse-class,pass,1,1,0,0
org.java_websocket.issues.Issue580Test.runNoCloseBlockingTestScenario0,reverse,pass,1,1,0,0
org.java_websocket.issues.Issue580Test.runNoCloseBlockingTestScenario2,original,pass,666,666,0,0
org.java_websocket.issues.Issue580Test.runNoCloseBlockingTestScenario2,random-class,pass,1653,1653,0,0
org.java_websocket.issues.Issue580Test.runNoCloseBlockingTestScenario2,random,flaky,1653,1652,0,1
org.java_websocket.issues.Issue580Test.runNoCloseBlockingTestScenario2,reverse-class,pass,1,1,0,0
org.java_websocket.issues.Issue580Test.runNoCloseBlockingTestScenario2,reverse,pass,1,1,0,0
org.java_websocket.issues.Issue580Test.runNoCloseBlockingTestScenario3,original,pass,666,666,0,0
org.java_websocket.issues.Issue580Test.runNoCloseBlockingTestScenario3,random-class,pass,1653,1653,0,0
org.java_websocket.issues.Issue580Test.runNoCloseBlockingTestScenario3,random,flaky,1653,1652,0,1
org.java_websocket.issues.Issue580Test.runNoCloseBlockingTestScenario3,reverse-class,pass,1,1,0,0
org.java_websocket.issues.Issue580Test.runNoCloseBlockingTestScenario3,reverse,pass,1,1,0,0
org.java_websocket.issues.Issue580Test.runNoCloseBlockingTestScenario4,original,pass,666,666,0,0
org.java_websocket.issues.Issue580Test.runNoCloseBlockingTestScenario4,random-class,flaky,1653,1651,0,2
org.java_websocket.issues.Issue580Test.runNoCloseBlockingTestScenario4,random,pass,1653,1653,0,0
org.java_websocket.issues.Issue580Test.runNoCloseBlockingTestScenario4,reverse-class,pass,1,1,0,0
org.java_websocket.issues.Issue580Test.runNoCloseBlockingTestScenario4,reverse,pass,1,1,0,0
org.java_websocket.issues.Issue580Test.runNoCloseBlockingTestScenario5,original,pass,666,666,0,0
org.java_websocket.issues.Issue580Test.runNoCloseBlockingTestScenario5,random-class,flaky,1653,1652,0,1
org.java_websocket.issues.Issue580Test.runNoCloseBlockingTestScenario5,random,pass,1653,1653,0,0
org.java_websocket.issues.Issue580Test.runNoCloseBlockingTestScenario5,reverse-class,pass,1,1,0,0
org.java_websocket.issues.Issue580Test.runNoCloseBlockingTestScenario5,reverse,pass,1,1,0,0
org.java_websocket.issues.Issue580Test.runNoCloseBlockingTestScenario8,original,pass,666,666,0,0
org.java_websocket.issues.Issue580Test.runNoCloseBlockingTestScenario8,random-class,pass,1653,1653,0,0
org.java_websocket.issues.Issue580Test.runNoCloseBlockingTestScenario8,random,flaky,1653,1652,0,1
org.java_websocket.issues.Issue580Test.runNoCloseBlockingTestScenario8,reverse-class,pass,1,1,0,0
org.java_websocket.issues.Issue580Test.runNoCloseBlockingTestScenario8,reverse,pass,1,1,0,0
org.java_websocket.issues.Issue677Test.testIssue,original,flaky,666,664,0,2
org.java_websocket.issues.Issue677Test.testIssue,random-class,flaky,1653,1536,0,117
org.java_websocket.issues.Issue677Test.testIssue,random,flaky,1653,1526,0,127
org.java_websocket.issues.Issue677Test.testIssue,reverse-class,pass,1,1,0,0
org.java_websocket.issues.Issue677Test.testIssue,reverse,pass,1,1,0,0
org.java_websocket.issues.Issue713Test.testIssue,original,pass,666,666,0,0
org.java_websocket.issues.Issue713Test.testIssue,random-class,flaky,1653,1651,0,2
org.java_websocket.issues.Issue713Test.testIssue,random,pass,1653,1653,0,0
org.java_websocket.issues.Issue713Test.testIssue,reverse-class,pass,1,1,0,0
org.java_websocket.issues.Issue713Test.testIssue,reverse,pass,1,1,0,0
org.java_websocket.misc.OpeningHandshakeRejectionTest.testHandshakeRejectionTestCase0,original,pass,666,666,0,0
org.java_websocket.misc.OpeningHandshakeRejectionTest.testHandshakeRejectionTestCase0,random-class,flaky,1653,1652,0,1
org.java_websocket.misc.OpeningHandshakeRejectionTest.testHandshakeRejectionTestCase0,random,pass,1653,1653,0,0
org.java_websocket.misc.OpeningHandshakeRejectionTest.testHandshakeRejectionTestCase0,reverse-class,pass,1,1,0,0
org.java_websocket.misc.OpeningHandshakeRejectionTest.testHandshakeRejectionTestCase0,reverse,pass,1,1,0,0
org.java_websocket.misc.OpeningHandshakeRejectionTest.testHandshakeRejectionTestCase10,original,flaky,666,652,0,14
org.java_websocket.misc.OpeningHandshakeRejectionTest.testHandshakeRejectionTestCase10,random-class,flaky,1653,1626,0,27
org.java_websocket.misc.OpeningHandshakeRejectionTest.testHandshakeRejectionTestCase10,random,flaky,1653,1652,0,1
org.java_websocket.misc.OpeningHandshakeRejectionTest.testHandshakeRejectionTestCase10,reverse-class,pass,1,1,0,0
org.java_websocket.misc.OpeningHandshakeRejectionTest.testHandshakeRejectionTestCase10,reverse,pass,1,1,0,0
org.java_websocket.misc.OpeningHandshakeRejectionTest.testHandshakeRejectionTestCase11,original,flaky,666,665,0,1
org.java_websocket.misc.OpeningHandshakeRejectionTest.testHandshakeRejectionTestCase11,random-class,flaky,1653,1652,0,1
org.java_websocket.misc.OpeningHandshakeRejectionTest.testHandshakeRejectionTestCase11,random,flaky,1653,1652,0,1
org.java_websocket.misc.OpeningHandshakeRejectionTest.testHandshakeRejectionTestCase11,reverse-class,pass,1,1,0,0
org.java_websocket.misc.OpeningHandshakeRejectionTest.testHandshakeRejectionTestCase11,reverse,pass,1,1,0,0
org.java_websocket.misc.OpeningHandshakeRejectionTest.testHandshakeRejectionTestCase1,original,pass,666,666,0,0
org.java_websocket.misc.OpeningHandshakeRejectionTest.testHandshakeRejectionTestCase1,random-class,pass,1653,1653,0,0
org.java_websocket.misc.OpeningHandshakeRejectionTest.testHandshakeRejectionTestCase1,random,flaky,1653,1649,0,4
org.java_websocket.misc.OpeningHandshakeRejectionTest.testHandshakeRejectionTestCase1,reverse-class,pass,1,1,0,0
org.java_websocket.misc.OpeningHandshakeRejectionTest.testHandshakeRejectionTestCase1,reverse,pass,1,1,0,0
org.java_websocket.misc.OpeningHandshakeRejectionTest.testHandshakeRejectionTestCase2,original,pass,666,666,0,0
org.java_websocket.misc.OpeningHandshakeRejectionTest.testHandshakeRejectionTestCase2,random-class,pass,1653,1653,0,0
org.java_websocket.misc.OpeningHandshakeRejectionTest.testHandshakeRejectionTestCase2,random,flaky,1653,1652,0,1
org.java_websocket.misc.OpeningHandshakeRejectionTest.testHandshakeRejectionTestCase2,reverse-class,pass,1,1,0,0
org.java_websocket.misc.OpeningHandshakeRejectionTest.testHandshakeRejectionTestCase2,reverse,pass,1,1,0,0
org.java_websocket.misc.OpeningHandshakeRejectionTest.testHandshakeRejectionTestCase3,original,pass,666,666,0,0
org.java_websocket.misc.OpeningHandshakeRejectionTest.testHandshakeRejectionTestCase3,random-class,pass,1653,1653,0,0
org.java_websocket.misc.OpeningHandshakeRejectionTest.testHandshakeRejectionTestCase3,random,flaky,1653,1652,0,1
org.java_websocket.misc.OpeningHandshakeRejectionTest.testHandshakeRejectionTestCase3,reverse-class,pass,1,1,0,0
org.java_websocket.misc.OpeningHandshakeRejectionTest.testHandshakeRejectionTestCase3,reverse,pass,1,1,0,0
org.java_websocket.misc.OpeningHandshakeRejectionTest.testHandshakeRejectionTestCase4,original,pass,666,666,0,0
org.java_websocket.misc.OpeningHandshakeRejectionTest.testHandshakeRejectionTestCase4,random-class,pass,1653,1653,0,0
org.java_websocket.misc.OpeningHandshakeRejectionTest.testHandshakeRejectionTestCase4,random,flaky,1653,1650,0,3
org.java_websocket.misc.OpeningHandshakeRejectionTest.testHandshakeRejectionTestCase4,reverse-class,pass,1,1,0,0
org.java_websocket.misc.OpeningHandshakeRejectionTest.testHandshakeRejectionTestCase4,reverse,pass,1,1,0,0
org.java_websocket.misc.OpeningHandshakeRejectionTest.testHandshakeRejectionTestCase5,original,pass,666,666,0,0
org.java_websocket.misc.OpeningHandshakeRejectionTest.testHandshakeRejectionTestCase5,random-class,pass,1653,1653,0,0
org.java_websocket.misc.OpeningHandshakeRejectionTest.testHandshakeRejectionTestCase5,random,flaky,1653,1651,0,2
org.java_websocket.misc.OpeningHandshakeRejectionTest.testHandshakeRejectionTestCase5,reverse-class,pass,1,1,0,0
org.java_websocket.misc.OpeningHandshakeRejectionTest.testHandshakeRejectionTestCase5,reverse,pass,1,1,0,0
org.java_websocket.misc.OpeningHandshakeRejectionTest.testHandshakeRejectionTestCase6,original,pass,666,666,0,0
org.java_websocket.misc.OpeningHandshakeRejectionTest.testHandshakeRejectionTestCase6,random-class,pass,1653,1653,0,0
org.java_websocket.misc.OpeningHandshakeRejectionTest.testHandshakeRejectionTestCase6,random,flaky,1653,1652,0,1
org.java_websocket.misc.OpeningHandshakeRejectionTest.testHandshakeRejectionTestCase6,reverse-class,pass,1,1,0,0
org.java_websocket.misc.OpeningHandshakeRejectionTest.testHandshakeRejectionTestCase6,reverse,pass,1,1,0,0
org.java_websocket.misc.OpeningHandshakeRejectionTest.testHandshakeRejectionTestCase7,original,pass,666,666,0,0
org.java_websocket.misc.OpeningHandshakeRejectionTest.testHandshakeRejectionTestCase7,random-class,pass,1653,1653,0,0
org.java_websocket.misc.OpeningHandshakeRejectionTest.testHandshakeRejectionTestCase7,random,flaky,1653,1650,0,3
org.java_websocket.misc.OpeningHandshakeRejectionTest.testHandshakeRejectionTestCase7,reverse-class,pass,1,1,0,0
org.java_websocket.misc.OpeningHandshakeRejectionTest.testHandshakeRejectionTestCase7,reverse,pass,1,1,0,0
org.java_websocket.misc.OpeningHandshakeRejectionTest.testHandshakeRejectionTestCase8,original,pass,666,666,0,0
org.java_websocket.misc.OpeningHandshakeRejectionTest.testHandshakeRejectionTestCase8,random-class,pass,1653,1653,0,0
org.java_websocket.misc.OpeningHandshakeRejectionTest.testHandshakeRejectionTestCase8,random,flaky,1653,1651,0,2
org.java_websocket.misc.OpeningHandshakeRejectionTest.testHandshakeRejectionTestCase8,reverse-class,pass,1,1,0,0
org.java_websocket.misc.OpeningHandshakeRejectionTest.testHandshakeRejectionTestCase8,reverse,pass,1,1,0,0
org.java_websocket.misc.OpeningHandshakeRejectionTest.testHandshakeRejectionTestCase9,original,pass,666,666,0,0
org.java_websocket.misc.OpeningHandshakeRejectionTest.testHandshakeRejectionTestCase9,random-class,pass,1653,1653,0,0
org.java_websocket.misc.OpeningHandshakeRejectionTest.testHandshakeRejectionTestCase9,random,flaky,1653,1652,0,1
org.java_websocket.misc.OpeningHandshakeRejectionTest.testHandshakeRejectionTestCase9,reverse-class,pass,1,1,0,0
org.java_websocket.misc.OpeningHandshakeRejectionTest.testHandshakeRejectionTestCase9,reverse,pass,1,1,0,0
org.java_websocket.protocols.ProtoclHandshakeRejectionTest.testHandshakeRejectionTestCase10,original,pass,666,666,0,0
org.java_websocket.protocols.ProtoclHandshakeRejectionTest.testHandshakeRejectionTestCase10,random-class,flaky,1653,1636,0,17
org.java_websocket.protocols.ProtoclHandshakeRejectionTest.testHandshakeRejectionTestCase10,random,flaky,1653,1649,0,4
org.java_websocket.protocols.ProtoclHandshakeRejectionTest.testHandshakeRejectionTestCase10,reverse-class,pass,1,1,0,0
org.java_websocket.protocols.ProtoclHandshakeRejectionTest.testHandshakeRejectionTestCase10,reverse,pass,1,1,0,0
org.java_websocket.protocols.ProtoclHandshakeRejectionTest.testHandshakeRejectionTestCase11,original,pass,666,666,0,0
org.java_websocket.protocols.ProtoclHandshakeRejectionTest.testHandshakeRejectionTestCase11,random-class,flaky,1653,1652,0,1
org.java_websocket.protocols.ProtoclHandshakeRejectionTest.testHandshakeRejectionTestCase11,random,flaky,1653,1651,0,2
org.java_websocket.protocols.ProtoclHandshakeRejectionTest.testHandshakeRejectionTestCase11,reverse-class,pass,1,1,0,0
org.java_websocket.protocols.ProtoclHandshakeRejectionTest.testHandshakeRejectionTestCase11,reverse,pass,1,1,0,0
org.java_websocket.protocols.ProtoclHandshakeRejectionTest.testHandshakeRejectionTestCase13,original,pass,666,666,0,0
org.java_websocket.protocols.ProtoclHandshakeRejectionTest.testHandshakeRejectionTestCase13,random-class,pass,1653,1653,0,0
org.java_websocket.protocols.ProtoclHandshakeRejectionTest.testHandshakeRejectionTestCase13,random,flaky,1653,1650,0,3
org.java_websocket.protocols.ProtoclHandshakeRejectionTest.testHandshakeRejectionTestCase13,reverse-class,pass,1,1,0,0
org.java_websocket.protocols.ProtoclHandshakeRejectionTest.testHandshakeRejectionTestCase13,reverse,pass,1,1,0,0
org.java_websocket.protocols.ProtoclHandshakeRejectionTest.testHandshakeRejectionTestCase14,original,pass,666,666,0,0
org.java_websocket.protocols.ProtoclHandshakeRejectionTest.testHandshakeRejectionTestCase14,random-class,pass,1653,1653,0,0
org.java_websocket.protocols.ProtoclHandshakeRejectionTest.testHandshakeRejectionTestCase14,random,flaky,1653,1651,0,2
org.java_websocket.protocols.ProtoclHandshakeRejectionTest.testHandshakeRejectionTestCase14,reverse-class,pass,1,1,0,0
org.java_websocket.protocols.ProtoclHandshakeRejectionTest.testHandshakeRejectionTestCase14,reverse,pass,1,1,0,0
org.java_websocket.protocols.ProtoclHandshakeRejectionTest.testHandshakeRejectionTestCase16,original,pass,666,666,0,0
org.java_websocket.protocols.ProtoclHandshakeRejectionTest.testHandshakeRejectionTestCase16,random-class,pass,1653,1653,0,0
org.java_websocket.protocols.ProtoclHandshakeRejectionTest.testHandshakeRejectionTestCase16,random,flaky,1653,1651,0,2
org.java_websocket.protocols.ProtoclHandshakeRejectionTest.testHandshakeRejectionTestCase16,reverse-class,pass,1,1,0,0
org.java_websocket.protocols.ProtoclHandshakeRejectionTest.testHandshakeRejectionTestCase16,reverse,pass,1,1,0,0
org.java_websocket.protocols.ProtoclHandshakeRejectionTest.testHandshakeRejectionTestCase17,original,pass,666,666,0,0
org.java_websocket.protocols.ProtoclHandshakeRejectionTest.testHandshakeRejectionTestCase17,random-class,pass,1653,1653,0,0
org.java_websocket.protocols.ProtoclHandshakeRejectionTest.testHandshakeRejectionTestCase17,random,flaky,1653,1651,0,2
org.java_websocket.protocols.ProtoclHandshakeRejectionTest.testHandshakeRejectionTestCase17,reverse-class,pass,1,1,0,0
org.java_websocket.protocols.ProtoclHandshakeRejectionTest.testHandshakeRejectionTestCase17,reverse,pass,1,1,0,0
org.java_websocket.protocols.ProtoclHandshakeRejectionTest.testHandshakeRejectionTestCase2,original,pass,666,666,0,0
org.java_websocket.protocols.ProtoclHandshakeRejectionTest.testHandshakeRejectionTestCase2,random-class,pass,1653,1653,0,0
org.java_websocket.protocols.ProtoclHandshakeRejectionTest.testHandshakeRejectionTestCase2,random,flaky,1653,1651,0,2
org.java_websocket.protocols.ProtoclHandshakeRejectionTest.testHandshakeRejectionTestCase2,reverse-class,pass,1,1,0,0
org.java_websocket.protocols.ProtoclHandshakeRejectionTest.testHandshakeRejectionTestCase2,reverse,pass,1,1,0,0
org.java_websocket.protocols.ProtoclHandshakeRejectionTest.testHandshakeRejectionTestCase3,original,pass,666,666,0,0
org.java_websocket.protocols.ProtoclHandshakeRejectionTest.testHandshakeRejectionTestCase3,random-class,pass,1653,1653,0,0
org.java_websocket.protocols.ProtoclHandshakeRejectionTest.testHandshakeRejectionTestCase3,random,flaky,1653,1651,0,2
org.java_websocket.protocols.ProtoclHandshakeRejectionTest.testHandshakeRejectionTestCase3,reverse-class,pass,1,1,0,0
org.java_websocket.protocols.ProtoclHandshakeRejectionTest.testHandshakeRejectionTestCase3,reverse,pass,1,1,0,0
org.java_websocket.protocols.ProtoclHandshakeRejectionTest.testHandshakeRejectionTestCase4,original,pass,666,666,0,0
org.java_websocket.protocols.ProtoclHandshakeRejectionTest.testHandshakeRejectionTestCase4,random-class,pass,1653,1653,0,0
org.java_websocket.protocols.ProtoclHandshakeRejectionTest.testHandshakeRejectionTestCase4,random,flaky,1653,1650,0,3
org.java_websocket.protocols.ProtoclHandshakeRejectionTest.testHandshakeRejectionTestCase4,reverse-class,pass,1,1,0,0
org.java_websocket.protocols.ProtoclHandshakeRejectionTest.testHandshakeRejectionTestCase4,reverse,pass,1,1,0,0
org.java_websocket.protocols.ProtoclHandshakeRejectionTest.testHandshakeRejectionTestCase6,original,pass,666,666,0,0
org.java_websocket.protocols.ProtoclHandshakeRejectionTest.testHandshakeRejectionTestCase6,random-class,pass,1653,1653,0,0
org.java_websocket.protocols.ProtoclHandshakeRejectionTest.testHandshakeRejectionTestCase6,random,flaky,1653,1651,0,2
org.java_websocket.protocols.ProtoclHandshakeRejectionTest.testHandshakeRejectionTestCase6,reverse-class,pass,1,1,0,0
org.java_websocket.protocols.ProtoclHandshakeRejectionTest.testHandshakeRejectionTestCase6,reverse,pass,1,1,0,0
org.java_websocket.protocols.ProtoclHandshakeRejectionTest.testHandshakeRejectionTestCase8,original,pass,666,666,0,0
org.java_websocket.protocols.ProtoclHandshakeRejectionTest.testHandshakeRejectionTestCase8,random-class,pass,1653,1653,0,0
org.java_websocket.protocols.ProtoclHandshakeRejectionTest.testHandshakeRejectionTestCase8,random,flaky,1653,1651,0,2
org.java_websocket.protocols.ProtoclHandshakeRejectionTest.testHandshakeRejectionTestCase8,reverse-class,pass,1,1,0,0
org.java_websocket.protocols.ProtoclHandshakeRejectionTest.testHandshakeRejectionTestCase8,reverse,pass,1,1,0,0
org.java_websocket.protocols.ProtoclHandshakeRejectionTest.testHandshakeRejectionTestCase9,original,pass,666,666,0,0
org.java_websocket.protocols.ProtoclHandshakeRejectionTest.testHandshakeRejectionTestCase9,random-class,pass,1653,1653,0,0
org.java_websocket.protocols.ProtoclHandshakeRejectionTest.testHandshakeRejectionTestCase9,random,flaky,1653,1652,0,1
org.java_websocket.protocols.ProtoclHandshakeRejectionTest.testHandshakeRejectionTestCase9,reverse-class,pass,1,1,0,0
org.java_websocket.protocols.ProtoclHandshakeRejectionTest.testHandshakeRejectionTestCase9,reverse,pass,1,1,0,0
org.recast4j.detour.tilecache.TileCacheTest.testPerformance,original,pass,1,1,0,0
org.recast4j.detour.tilecache.TileCacheTest.testPerformance,random,flaky,49,48,0,1
org.springframework.cloud.aws.cache.config.xml.CacheBeanDefinitionParserTest.parseInternal_cacheConfigWithExpiration_returnsConfiguredCacheThatRespectExpiration,original,pass,2,2,0,0
org.springframework.cloud.aws.cache.config.xml.CacheBeanDefinitionParserTest.parseInternal_cacheConfigWithExpiration_returnsConfiguredCacheThatRespectExpiration,random,flaky,100,99,0,1
org.vertexium.accumulo.AccumuloGraphTest.testFindPathsMultiplePaths,original,flaky,2,1,0,1
org.vertexium.accumulo.AccumuloGraphTest.testFindRelatedEdgesPerformance,original,flaky,2,1,0,1
org.vertexium.inmemory.InMemoryGraphTest.manyVisibilities,original,failure,2,0,0,2
org.vertexium.inmemory.InMemoryGraphTest.manyVisibilities,random,pass,100,100,0,0
org.vertexium.inmemory.InMemoryGraphTest.testMarkPropertyVisible,original,pass,2,2,0,0
org.vertexium.inmemory.InMemoryGraphTest.testMarkPropertyVisible,random,flaky,100,99,0,1
org.vertexium.util.IncreasingTimeTest.currentTimeMillisReturnsTimeGreaterThanSystemTime,original,pass,2,2,0,0
org.vertexium.util.IncreasingTimeTest.currentTimeMillisReturnsTimeGreaterThanSystemTime,random,flaky,104,84,0,20
org.wso2.carbon.apimgt.throttling.siddhi.extension.ThrottleTimeBatchWindowTestCase.throttleTimeWindowBatchTest1,original,pass,100,100,0,0
org.wso2.carbon.apimgt.throttling.siddhi.extension.ThrottleTimeBatchWindowTestCase.throttleTimeWindowBatchTest1,random,flaky,100,99,0,1
org.zalando.riptide.backup.BackupRequestPluginTest.shouldUseBackupRequest,original,pass,3,3,0,0
org.zalando.riptide.backup.BackupRequestPluginTest.shouldUseBackupRequest,random,flaky,100,99,0,1
org.zalando.riptide.failsafe.RetryAfterDelayFunctionTest.shouldRetryOnDemandWithDynamicDelay,original,pass,3,3,0,0
org.zalando.riptide.failsafe.RetryAfterDelayFunctionTest.shouldRetryOnDemandWithDynamicDelay,random,flaky,100,99,0,1
retrofit2.adapter.rxjava.CancelDisposeTest.cancelDoesNotDispose,original,pass,87,87,0,0
retrofit2.adapter.rxjava.CancelDisposeTest.cancelDoesNotDispose,random-class,pass,331,331,0,0
retrofit2.adapter.rxjava.CancelDisposeTest.cancelDoesNotDispose,random,flaky,331,330,0,1
retrofit2.adapter.rxjava.CancelDisposeTest.cancelDoesNotDispose,reverse-class,pass,1,1,0,0
retrofit2.adapter.rxjava.CancelDisposeTest.cancelDoesNotDispose,reverse,pass,1,1,0,0
retrofit2.adapter.rxjava.CompletableThrowingSafeSubscriberTest.throwingInOnCompleteDeliveredToPlugin,original,pass,87,87,0,0
retrofit2.adapter.rxjava.CompletableThrowingSafeSubscriberTest.throwingInOnCompleteDeliveredToPlugin,random-class,flaky,331,330,0,1
retrofit2.adapter.rxjava.CompletableThrowingSafeSubscriberTest.throwingInOnCompleteDeliveredToPlugin,random,pass,331,331,0,0
retrofit2.adapter.rxjava.CompletableThrowingSafeSubscriberTest.throwingInOnCompleteDeliveredToPlugin,reverse-class,pass,1,1,0,0
retrofit2.adapter.rxjava.CompletableThrowingSafeSubscriberTest.throwingInOnCompleteDeliveredToPlugin,reverse,pass,1,1,0,0
retrofit2.adapter.rxjava.CompletableThrowingTest.bodyThrowingInOnErrorDeliveredToPlugin,original,pass,87,87,0,0
retrofit2.adapter.rxjava.CompletableThrowingTest.bodyThrowingInOnErrorDeliveredToPlugin,random-class,flaky,331,330,0,1
retrofit2.adapter.rxjava.CompletableThrowingTest.bodyThrowingInOnErrorDeliveredToPlugin,random,pass,331,331,0,0
retrofit2.adapter.rxjava.CompletableThrowingTest.bodyThrowingInOnErrorDeliveredToPlugin,reverse-class,pass,1,1,0,0
retrofit2.adapter.rxjava.CompletableThrowingTest.bodyThrowingInOnErrorDeliveredToPlugin,reverse,pass,1,1,0,0
retrofit2.adapter.rxjava.CompletableThrowingTest.throwingInOnCompleteDeliveredToPlugin,original,pass,87,87,0,0
retrofit2.adapter.rxjava.CompletableThrowingTest.throwingInOnCompleteDeliveredToPlugin,random-class,flaky,331,329,0,2
retrofit2.adapter.rxjava.CompletableThrowingTest.throwingInOnCompleteDeliveredToPlugin,random,flaky,331,330,0,1
retrofit2.adapter.rxjava.CompletableThrowingTest.throwingInOnCompleteDeliveredToPlugin,reverse-class,pass,1,1,0,0
retrofit2.adapter.rxjava.CompletableThrowingTest.throwingInOnCompleteDeliveredToPlugin,reverse,pass,1,1,0,0
retrofit2.adapter.rxjava.ObservableThrowingTest.responseThrowingInOnCompleteDeliveredToPlugin,original,pass,87,87,0,0
retrofit2.adapter.rxjava.ObservableThrowingTest.responseThrowingInOnCompleteDeliveredToPlugin,random-class,pass,331,331,0,0
retrofit2.adapter.rxjava.ObservableThrowingTest.responseThrowingInOnCompleteDeliveredToPlugin,random,flaky,331,330,0,1
retrofit2.adapter.rxjava.ObservableThrowingTest.responseThrowingInOnCompleteDeliveredToPlugin,reverse-class,pass,1,1,0,0
retrofit2.adapter.rxjava.ObservableThrowingTest.responseThrowingInOnCompleteDeliveredToPlugin,reverse,pass,1,1,0,0
retrofit2.adapter.rxjava.SingleThrowingTest.bodyThrowingInOnSuccessDeliveredToPlugin,original,pass,87,87,0,0
retrofit2.adapter.rxjava.SingleThrowingTest.bodyThrowingInOnSuccessDeliveredToPlugin,random-class,pass,331,331,0,0
retrofit2.adapter.rxjava.SingleThrowingTest.bodyThrowingInOnSuccessDeliveredToPlugin,random,flaky,331,330,0,1
retrofit2.adapter.rxjava.SingleThrowingTest.bodyThrowingInOnSuccessDeliveredToPlugin,reverse-class,pass,1,1,0,0
retrofit2.adapter.rxjava.SingleThrowingTest.bodyThrowingInOnSuccessDeliveredToPlugin,reverse,pass,1,1,0,0
retrofit2.adapter.rxjava.SingleThrowingTest.responseThrowingInOnSuccessDeliveredToPlugin,original,pass,87,87,0,0
retrofit2.adapter.rxjava.SingleThrowingTest.responseThrowingInOnSuccessDeliveredToPlugin,random-class,flaky,331,329,0,2
retrofit2.adapter.rxjava.SingleThrowingTest.responseThrowingInOnSuccessDeliveredToPlugin,random,flaky,331,330,0,1
retrofit2.adapter.rxjava.SingleThrowingTest.responseThrowingInOnSuccessDeliveredToPlugin,reverse-class,pass,1,1,0,0
retrofit2.adapter.rxjava.SingleThrowingTest.responseThrowingInOnSuccessDeliveredToPlugin,reverse,pass,1,1,0,0
retrofit2.CallTest.cancelOkHttpRequest,original,pass,87,87,0,0
retrofit2.CallTest.cancelOkHttpRequest,random-class,flaky,331,328,0,3
retrofit2.CallTest.cancelOkHttpRequest,random,flaky,331,328,0,3
retrofit2.CallTest.cancelOkHttpRequest,reverse-class,pass,1,1,0,0
retrofit2.CallTest.cancelOkHttpRequest,reverse,pass,1,1,0,0
retrofit2.CallTest.cancelRequest,original,pass,87,87,0,0
retrofit2.CallTest.cancelRequest,random-class,flaky,331,330,0,1
retrofit2.CallTest.cancelRequest,random,flaky,331,330,0,1
retrofit2.CallTest.cancelRequest,reverse-class,pass,1,1,0,0
retrofit2.CallTest.cancelRequest,reverse,pass,1,1,0,0
ro.isdc.wro.extensions.processor.TestBourbonCssProcessor.shouldBeThreadSafe,original,pass,34,34,0,0
ro.isdc.wro.extensions.processor.TestBourbonCssProcessor.shouldBeThreadSafe,random-class,pass,116,116,0,0
ro.isdc.wro.extensions.processor.TestBourbonCssProcessor.shouldBeThreadSafe,random,flaky,116,114,0,2
ro.isdc.wro.extensions.processor.TestBourbonCssProcessor.shouldBeThreadSafe,reverse-class,pass,1,1,0,0
ro.isdc.wro.extensions.processor.TestBourbonCssProcessor.shouldBeThreadSafe,reverse,pass,1,1,0,0
ro.isdc.wro.extensions.processor.TestRubySassCssProcessor.shouldBeThreadSafeWhenInitializingProcessor,original,pass,34,34,0,0
ro.isdc.wro.extensions.processor.TestRubySassCssProcessor.shouldBeThreadSafeWhenInitializingProcessor,random-class,pass,116,116,0,0
ro.isdc.wro.extensions.processor.TestRubySassCssProcessor.shouldBeThreadSafeWhenInitializingProcessor,random,flaky,116,114,0,2
ro.isdc.wro.extensions.processor.TestRubySassCssProcessor.shouldBeThreadSafeWhenInitializingProcessor,reverse-class,pass,1,1,0,0
ro.isdc.wro.extensions.processor.TestRubySassCssProcessor.shouldBeThreadSafeWhenInitializingProcessor,reverse,pass,1,1,0,0
ro.pippo.session.jedis.JedisSessionDataStorageTest.testDelete,original,flaky,21,2,0,19
ro.pippo.session.jedis.JedisSessionDataStorageTest.testDelete,random,pass,100,100,0,0
ro.pippo.session.mongodb.MongoDBSessionDataStorageTest.testCreate,original,pass,8,8,0,0
ro.pippo.session.mongodb.MongoDBSessionDataStorageTest.testCreate,random,flaky,110,107,0,3
ro.pippo.session.mongodb.MongoDBSessionDataStorageTest.testDelete,original,pass,8,8,0,0
ro.pippo.session.mongodb.MongoDBSessionDataStorageTest.testDelete,random,flaky,110,109,0,1
ro.pippo.session.mongodb.MongoDBSessionDataStorageTest.testGet,original,pass,8,8,0,0
ro.pippo.session.mongodb.MongoDBSessionDataStorageTest.testGet,random,flaky,110,109,0,1
ro.pippo.session.mongodb.MongoDBSessionDataStorageTest.testSave,original,pass,8,8,0,0
ro.pippo.session.mongodb.MongoDBSessionDataStorageTest.testSave,random,flaky,110,108,0,2
timely.store.iterators.TimeSeriesGroupingIteratorTest.testMultipleTimeSeriesMovingAverage,original,pass,2,2,0,0
timely.store.iterators.TimeSeriesGroupingIteratorTest.testMultipleTimeSeriesMovingAverage,random,flaky,142,138,0,4
uk.co.flax.luwak.matchers.TestParallelMatcher.testParallelSlowLog,original,pass,2,2,0,0
uk.co.flax.luwak.matchers.TestParallelMatcher.testParallelSlowLog,random,flaky,100,98,0,2
uk.co.flax.luwak.matchers.TestPartitionMatcher.testParallelSlowLog,original,pass,2,2,0,0
uk.co.flax.luwak.matchers.TestPartitionMatcher.testParallelSlowLog,random,flaky,100,99,0,1
